OECOL	OECOLOGY
OECON	OECONOMY
ABAT	ABATEMENT
ABBR	ABBREVIATION
ABDOM	ABDOMINAL
ABEOK	ABEOKUTA
ABERD	ABERDEEN
ABID	ABIDING
ABIL	ABILIT
ABINGT	ABINGTON
ABNORM	ABNORMAL
ABORIG	ABORIG
ABORT	ABORT
ABRAS	ABRASIVE
ABR	ABRIDGED
ABR	ABRIDGMENT
ABSENT	ABSENTEISM
ABSORPT	ABSORPTION
ABSTIN	ABSTINENCE
ABSTR	ABSTRACT
ABUND	ABUNDANT
ABUS	ABUS
ACAD	ACADEMY
ACARIC	ACARICIDE
ACAROL	ACAROLOGY
ACCEL	ACCELERATATION
ACCEPT	ACCEPT
ACCESS	ACCESSING
ACCESS	ACCESSION
ACCID	ACCIDENT
ACCLIM	ACCLIMAT
ACCOMMOD	ACCOMMODAT
ACCOMOD	ACCOMODATION
ACCO	ACCOMPANY
ACCORD	ACCORD
ACC	ACCOUNT
ACCOUNT	ACCOUNTABILITY
ACCOUNT	ACCOUNTANCY
ACCOUNT	ACCOUNTANT
ACCOUNT	ACCOUNTING
ACCREDIT	ACCREDITED
ACCULT	ACCULTUR
ACCUMUL	ACCUMULATIVE
ACCUMUL	ACCUMULATOR
ACHIEV	ACHIEVEMENT
ACHIEV	ACHIEVER
ACHIEV	ACHIEVING
ACIDIF	ACIDIFICAT
ACOUST	ACOUSTI
ACOUSTOELECTRON	ACOUSTOELECTRONICS
ACQUIR	ACQUIR
ACQUIS	ACQUISITION
ACROBAT	ACROBATIC
ACRON	ACRONYM
ACT	ACTING
ACTINOTHER	ACTINOTHERAP
ACTUAL	ACTUALI
ACTUAR	ACTUAR
ACUPUNCT	ACUPUNCTURE
ADAMANT	ADAMANTINE
ADAPT	ADAPTATION
ADAPTOG	ADAPTOGEN
ADB	ADBOOK
ADDICT	ADDICTI
ADDINGT	ADDINGTON
ADDIT	ADDITION
ADDIT	ADDITIVE
ADEL	ADELAIDE
ADIROND	ADIRONDACK
ADJOIN	ADJOIN
ADJUN	ADJUNCT
ADJUST	ADJUSTEMENT
ADJUST	ADJUSTER
ADJUT	ADJUTANT
ADJUV	ADJUVAN
ADLETT	ADLETTER
ADM	ADMINISTER
ADMIR	ADMIRALTY
ADMISS	ADMISSION
ADMIX	ADMIXTURE
ADOLESC	ADOLESCEN
ADREN	ADRENERG
ADSORPT	ADSORPTI
ADV	ADVANCED
ADVANT	ADVANTAGE
ADVENT	ADVENTIST
ADVERT	ADVERTIS
ADVIS	ADVIS
AER	AERIAL
AEROB	AEROBIC
AEROBIOL	AEROBIOLOGY
AEROIONIZ	AEROIONIZ
AEROJ	AEROJET
AEROMAGN	AEROMAGNETIC
AEROMED	AEROMEDICA
AEROPL	AEROPLAN
AEROSP	AEROSPACE
AEROSP	AEROSPATIAL
AEROTHERMOCHEM	AEROTHERMOCHEMISTRY
AEROTHERMODYN	AEROTHERMODYNAMI
AESTHET	AESTHETICS
AFF	AFFAIR
AFFECT	AFFECT
AFFIL	AFFILI
AFFILIATESH	AFFILIATESHIP
AFFIRM	AFFIRM
AFFORDABIL	AFFORDABILITY
AFFORD	AFFORDABLE
AFR	AFRICA
AFROASIAT	AFROASIATIC
AFTERLOAD	AFTERLOADING
AFTERMARK	AFTERMARKET
AFTERTREAT	AFTERTREATMENT
AGBIOIND	AGBIOINDUSTRY
AGGLOM	AGGLOMERAT
AGGREG	AGGREGATE
AGGREG	AGGREGATION
AGGRESS	AGGRESSI
AGRAR	AGRARI
AGREEM	AGREEMENT
AGRIBIOL	AGRIBIOLOGY
AGRICHEM	AGRICHEMICAL
AGRIC	AGRICOL
AGRIC	AGRICULT
AGROCHEM	AGROCHEMISTRY
AGROECOL	AGROECOL
AGROFOR	AGROFORESTRY
AILM	AILMENT
AIRBR	AIRBRUSH
AIRCR	AIRCRAFT
AIRF	AIRFORCE
AIRFR	AIRFREIGHT
AIRL	AIRLINE
AIRPL	AIRPLANE
AIRPT	AIRPORT
AIRSH	AIRSHIP
AIRSP	AIRSPACE
AIRW	AIRWAY
AIRWORTH	AIRWORTHINESS
ALA	ALABAMA
ALTA	ALBERTA
ALTA	ALBERTAN
ALBUQ	ALBUQUERQUE
ALCHEM	ALCHEMIST
ALCOHOL	ALCOHOLI
ALGONQ	ALGONQUIAN
ALGONQ	ALGONQUIN
ALKYLAT	ALKYLAT
ALLEGH	ALLEGHENY
ALLELOCHEM	ALLELOCHEMISTRY
ALLELOPATH	ALLELOPATH
ALLERG	ALLERGEN
ALLERG	ALLERGI
ALLOT	ALLOTMENT
ALLOW	ALLOW
ALLOY	ALLOY
ALLUM	ALLUMIN
ALM	ALMANAC
ALPH	ALPHABET
ALP	ALPINE
ALTER	ALTERATION
ALTERN	ALTERNAT
ALT	ALTITUDE
ALUM	ALUMINIUM
AMALGAM	AMALGAMATE
AMARAN	AMARANTH
AMAZ	AMAZ
AMBULANC	AMBULANC
AMBUL	AMBULATORY
AMEND	AMEND
AM	AMERICA
AMITYV	AMITYVILLE
AMMON	AMMONIA
AMMUNIT	AMMUNITION
AMORPH	AMORPH
AMOUNT	AMOUNT
AMPLIF	AMPLIFICATION
AMPLIF	AMPLIFIER
AMUS	AMUSEMENT
AMYOTROPH	AMYOTROPHIC
ANAB	ANABOLI
ANAEROB	ANAEROBIC
ANAESTH	ANAESTHESIA
ANAESTHESIOL	ANAESTHESIOLOGY
ANAESTH	ANAESTHET
AN	ANALS
ANAL	ANALYT
ANAL	ANALYZ
ANAM	ANAMBRA
ANAPHYL	ANAPHYLAXIE
ANATOL	ANATOLIAN
ANAT	ANATOMY
ANC	ANCIENT
ANDROG	ANDROGEN
ANDROL	ANDROLOGY
ANESTH	ANESTHES
ANESTHESIOL	ANESTHESIOLOGY
ANESTH	ANESTHET
ANGIOGR	ANGIOGRAPHY
ANGIOTHER	ANGIOTHERAP
ANGL	ANGLICAN
ANIMAT	ANIMAT
ANKYL	ANKYLOSING
ANN	ANNAL
ANNAP	ANNAPOLIS
ANNIV	ANNIVERS
ANNOT	ANNOTAT
ANNOUNC	ANNOUNC
ANNU	ANNU
ANOINT	ANOINTING
ANOM	ANOMALY
ANON	ANONYMOUS
ANSW	ANSWER
ANTARCT	ANTARCTI
ANTHROPOG	ANTHROPOGEN
ANTHROPOR	ANTHROPOGRAPHY
ANTHROPOS	ANTHROPOSOPHY
ANTIDUMP	ANTIDUMPING
ANTIARRHYTHM	ANTIARRHYTHMIC
ANTIBACT	ANTIBACTERIAL
ANTIBIOTHER	ANTIBIOTHERAP
ANTIB	ANTIBODY
ANTICANCER	ANTICANCER
ANTICARCINOG	ANTICARCINOGEN
ANTICIP	ANTICIPATION
ANTIFUNG	ANTIFUNG
ANTIHYPERTENS	ANTIHYPERTENSI
ANTIMALAR	ANTIMALARIA
ANTIMICROB	ANTIMICROBI
ANTINEOPLAST	ANTINEOPLASTIC
ANTINUCL	ANTINUCLEAR
ANTINUTR	ANTINUTRIENT
ANTIOXID	ANTIOXIDANT
ANTIPOLLUT	ANTIPOLLUTION
ANTIQ	ANTIQU
ANTIRECESS	ANTIRECESSI
ANTIRETROVIR	ANTIRETROVIR
ANTIRHEUM	ANTIRHEUMATI
ANTISEISM	ANTISEISMI
ANTITUBERC	ANTITUBERCULOS
ANTIVIR	ANTIVIRAL
APARTM	APARTMENT
APATHOG	APATHOGENIC
APHAER	APHAERE
APHER	APHERE
APIC	APICULT
APL	APLICA
APOSTOL	APOSTOLATE
APOSTOL	APOSTOLIC
APPALACH	APPALACHIAN
APPAR	APPAREL
APPEAR	APPEAR
APPET	APPETISER
APPL	APPLIANCE
APPL	APPLICA
APPL	APPLIED
APPL	APPLYING
APPOINT	APPOINT
APPOINTM	APPOINTMENT
APPRAIS	APPRAIS
APPREC	APPRECIATION
APPRENT	APPRENTIC
APPRENTICESH	APPRENTICESHIP
APPROPR	APPROPRIATE
APPROPR	APPROPRIATION
APPROV	APPROV
APPROX	APPROXIMATION
APRAX	APRAX
APRIC	APRICOT
AQUAC	AQUACULTUR
AQUARIC	AQUARICULTUR
AQUATECH	AQUATECH
ARBORIC	ARBORICULT
ARCHAEOASTRON	ARCHAEOASTRONOM
ARCHAEOL	ARCHAEOLOGY
ARCHAEOMETALL	ARCHAEOMETALLURG
ARCHAEOM	ARCHAEOMETER
ARCHDEAC	ARCHDEACONRY
ARCHDIOC	ARCHDIOCESE
ARCHEOL	ARCHEOLOGY
ARCHIPEL	ARCHIPELAGO
ARCHIT	ARCHITECTURE
ARCHITECTON	ARCHITECTONI
ARCT	ARCTIC
ARGON	ARGONAUT
ARIS	ARISING
ARISTOT	ARISTOTEL
ARITH	ARITHMETIC
ARIZ	ARIZONA
ARK	ARKANSAS
ARLINGT	ARLINGTON
ARMD	ARMDALE
ARMEN	ARMENIA
ARMEN	ARMENIAN
AROMATHER	AROMATHERAPY
ARRANGE	ARRANGEMENT
ARREAR	ARREAR
ARRHYTHM	ARRHYTHMIAS
ARRIV	ARRIVAL
ARROWH	ARROWHEAD
ARTHEROSCLER	ARTHEROSCLEROS
ARTHROPLAST	ARTHROPLAST
ARTHROSC	ARTHROSCOP
ARTHROSC	ARTHROSCOPY
ARTHUR	ARTHURIAN
ARTICUL	ARTICUL
ARTIF	ARTIFICI
ARTILL	ARTILLERY
ASBESTOS	ASBESTOSIS
ASHF	ASHFORD
ASHKEN	ASHKENAZIC
ASIST	ASISTENC
ASSAY	ASSAYER
ASSERT	ASSERT
ASSESS	ASSESSED
ASSESS	ASSESSING
ASSESS	ASSESSMENT
ASSIGN	ASSIGNMENT
ASSIM	ASSIMIL
ASSOC	ASSOCIATION
ASSUMPT	ASSUMPTION
ASSUR	ASSUR
ASTEROSEISMOL	ASTEROSEISMOLOGY
ASTONISH	ASTONISHING
ASTROBIOL	ASTROBIOLOGY
ASTROCHEM	ASTROCHEMISTRY
ASTRODYN	ASTRODYNAM
ASTROM	ASTROMETER
ASTROPART	ASTROPARTICLE
ASYMPTOT	ASYMPTOTIC
ATHEN	ATHENIAN
ATHEROG	ATHEROGEN
ATHEROSCLER	ATHEROSCLERO
ATHEROSCLEROL	ATHEROSCLEROLOGY
ATHL	ATHLETIC
ATL	ATLANTI
ATL	ATLANTIC
ATR	ATRIAL
ATTAIN	ATTAINMENT
ATTEND	ATTENDANCE
ATTEN	ATTENTION
ATTY	ATTORNEY
ATTRACT	ATTRACTION
ATTRACT	ATTRACTIVE
ATYP	ATYPICAL
AUCHEN	AUCHENORRHYNCHA
AUCKL	AUCKLAND
AUCTION	AUCTION
AUDACC	AUDACCOUNT
AUDIOV	AUDIOVISUAL
AUDIOV	AUDIOVISION
AUDIOV	AUDIOVISUAL
AUGUSTIN	AUGUSTINIAN
AUROR	AURORAL
AUSTRALAS	AUSTRALASIA
AUTHENT	AUTHENTICITY
AUTH	AUTHORIS
AUTH	AUTHORITY
AUTH	AUTHORIZ
AUTOIMMUN	AUTOIMMUNIT
AUTOIONIZ	AUTOIONIZATION
AUTOMOB	AUTOMOBIL
AUTOMOT	AUTOMOTIVE
AUTOXID	AUTOXIDATION
AUX	AUXILIA
AVAILAB	AVAILABILITY
AVENG	AVENGER
AVE	AVENUE
AVER	AVERAGE
AVIAT	AVIATION
AVIAT	AVIATOR
AVION	AVION
AVOID	AVOID
AWAK	AWAK
AWARD	AWARD
AWARE	AWARENESS
AYRSH	AYRSHIRE
BABYLON	BABYLONIAN
BABYSITT	BABYSITT
BACILL	BACILLARY
BACKCALC	BACKCALCULAT
BACKGAM	BACKGAMMON
BACKGR	BACKGROUND
BACKPACK	BACKPACKER
BACKWOODSM	BACKWOODSMAN
BACT	BACTERIA
BACT	BACTERIE
BACTERIOL	BACTERIOLOGY
BACT	BACTERIUM
BAK	BAKER
BAK	BAKING
BALC	BALCANIC
BALLAD	BALLAD
BALLER	BALLERINA
BALLIST	BALLISTI
BALLOON	BALLOON
BALNEOTHER	BALNEOTHERAP
BALTIM	BALTIMORE
BAMF	BAMFIELD
BANAN	BANAN
BAND	BANDING
BANDSM	BANDSMAN
BANDWAG	BANDWAGON
BANG	BANGOR
BANK	BANKER
BANK	BANKING
BANKST	BANKSTOWN
BAPTIST	BAPTIST
BARBAR	BARBAR
BARGAIN	BARGAIN
BARIATR	BARIATRIC
BARK	BARKER
BARORECEPT	BARORECEPTOR
BARRINGT	BARRINGTON
BARRYT	BARRYTOWN
BART	BARTER
BASEB	BASEBALL
BASIC	BASICALLY
BASIL	BASILIAN
BASKETB	BASKETBALL
BASKETMAK	BASKETMAKER
BASS	BASSIST
BASSOON	BASSOONIST
BASUTOL	BASUTOLAND
BATH	BATHING
BATHR	BATHROOM
BATHYMETR	BATHYMETRI
BATTER	BATTER
BATTLEF	BATTLEFIELD
BATTLEF	BATTLEFORD
BAVAR	BAVARIAN
BAYL	BAYLOR
BEAC	BEACON
BEACONSFLD	BEACONSFIELD
BEAMSV	BEAMSVILLE
BEAR	BEARER
BEAR	BEARING
BEATIT	BEATITUDE
BEAUCEV	BEAUCEVILLE
BECHUANAL	BECHUANALAND
BECOM	BECOMING
BEDS	BEDFORDSHIRE
BEECHCR	BEECHCRAFT
BEEKEEP	BEEKEEPER
BEEKEEP	BEEKEEPING
BEFRIEND	BEFRIENDING
BEGIN	BEGINNER
BEGIN	BEGINNING
BEHAV	BEHAVIOR
BEHAV	BEHAVIOUR
BELARUS	BELARUSSIAN
BELF	BELFAST
BELG	BELGI
BELONG	BELONG
BENEF	BENEFICIENCE
BENTHOL	BENTHOLOGY
BEREAVE	BEREAVEMENT
BERGENF	BERGENFIELD
BERKS	BERKSHIRE
BERMUD	BERMUD
BERMUDAGR	BERMUDAGRASS
BERWICKS	BERWICKSHIRE
BESTSELL	BESTSELLER
BIWKLY	BIWEEKLY
BIANNU	BIANNUAL
BIBLIOSERV	BIBLIOSERVICE
BIBL	BIBLIOTHEC
BICENTEN	BICENTEN
BICYCL	BICYCL
BIEN	BIENAL
BIENN	BIENNIAL
BIENN	BIENNUAL
BIFIDOBACT	BIFIDOBACTERI
BILATER	BILATERAL
BILHARZ	BILHARZIASIS
BILING	BILINGU
BILLEN	BILLENNIUM
BIMON	BIMONTHLY
BIN	BINAR
BINATL	BINATIONAL
BIND	BIND
BINGHAMT	BINGHAMTON
BINOCUL	BINOCULAR
BIOACT	BIOACTIVE
BIOANAL	BIOANALY
BIOAVAILAB	BIOAVAILABILITY
BIOBEHAV	BIOBEHAV
BIOCATAL	BIOCATALY
BIOCENOL	BIOCENOLOGY
BIOCERAM	BIOCERAMI
BIOCHEM	BIOCHEMISTRY
BIOCLIMATOL	BIOCLIMATOLOGY
BIOCOMPAT	BIOCOMPATIBIL
BIOCOMPUT	BIOCOMPUT
BIOCONC	BIOCONCENTRAT
BIOCYBERN	BIOCYBERNETIC
BIODEGRAD	BIODEGRAD
BIODETERIOR	BIODETERIORAT
BIODIVERS	BIODIVERSITY
BIODYN	BIODYNAMIC
BIOELECTR	BIOELECTRICITY
BIOELECTROANAL	BIOELECTROANALY
BIOELECTROMAGN	BIOELECTROMAGN
BIOELECTRON	BIOELECTRONICS
BIOENG	BIOENGINEERING
BIOETH	BIOETHICS
BIOGENER	BIOGENERAT
BIOGENET	BIOGENET
BIOGEOCHEM	BIOGEOCHEMISTRY
BIOHYDROMETALL	BIOHYDROMETALLURG
BIOIND	BIOINDUSTRY
BIOINFORMA	BIOINFORMATICS
BIOLUMIN	BIOLUMINESCEN
BIOMAGN	BIOMAGNETI
BIOMARK	BIOMARKER
BIOMED	BIOMEDIC
BIOMEMBR	BIOMEMBRAN
BIOMIM	BIOMIMETIC
BIOMOL	BIOMOLECULAR
BIONANOTECHNOL	BIONANOTECHNOLOGY
BIOPATHOL	BIOPATHOLOGY
BIOPESTIC	BIOPESTICID
BIOPHARM	BIOPHARMACEUT
BIOPREP	BIOPREPAR
BIOPROCESS	BIOPROCESSING
BIOPROD	BIOPRODUCTION
BIOPSYCHOSOC	BIOPSYCHOSOCIAL
BIOREACT	BIOREACTI
BIOREACT	BIOREACTOR
BIORECOGNIT	BIORECOGNITION
BIORESOUR	BIORESOURC
BIORGAN	BIORGANIC
BIORYTHM	BIORYTHM
BIOSAF	BIOSAFETY
BIOSCI	BIOSCIENCE
BIOSENS	BIOSENSOR
BIOSENS	BIOSENSORS
BIOSEP	BIOSEPARATION
BIOSOC	BIOSOCIAL
BIOSTAT	BIOSTATIST
BIOSTEREOM	BIOSTEREOMETER
BIOSYNTH	BIOSYNTHESIS
BIOSYST	BIOSYSTEM
BIOTEST	BIOTEST
BIOTREAT	BIOTREATMENT
BIRD	BIRDING
BIRDKEEP	BIRDKEEPER
BIRM	BIRMINGHAM
BIRTHD	BIRTHDAY
BIRTHPL	BIRTHPLACE
BISANNU	BISANNUEL
BISH	BISHOP
BISH STORTFORD	BISHOPS STORTFORD
BISTAB	BISTABILITY
BITUM	BITUMEN
BITUM	BITUMINOUS
BIWKLY	BIWEEKLY
BLACKSBG	BLACKSBURG
BLACKSM	BLACKSMITH
BLEACH	BLEACH
BLENH	BLENHEIM
BLESS	BLESSING
BLIND	BLIND
BLOOM	BLOOM
BLOOMINGT	BLOOMINGTON
BLOSS	BLOSSOM
BLUEB	BLUEBOOK
BLUEPR	BLUEPRINT
BOARD	BOARDER
BOARD	BOARDING
BOARDR	BOARDROOM
BOARDSAIL	BOARDSAILOR
BOATBUILD	BOATBUILD
BOAT	BOATING
BODYBUILD	BODYBUILDER
BODYBUILD	BODYBUILDING
BODYTRAIN	BODYTRAINING
BODYW	BODYWORK
BOIL	BOIL
BOILERH	BOILERHOUS
BOND	BOND
BOOKBIND	BOOKBIND
BOOKBUY	BOOKBUYER
BOOKDEAL	BOOKDEALER
BOOKF	BOOKFUND
BOOK	BOOKING
BOOKKEEP	BOOKKEEP
BOOKKEEP	BOOKKEEPER
BOOKL	BOOKLET
BOOKMAK	BOOKMAKER
BOOKM	BOOKMAN
BOOKMARK	BOOKMARK
BOOKPL	BOOKPLATE
BOOKS	BOOKSELL
BOOKST	BOOKSTORE
BOOKW	BOOKWORM
BOOST	BOOST
BORD	BORDER
BORDERL	BORDERLAND
BOREH	BOREHOLE
BORROW	BORROWING
BORST	BORSTAL
BOTSW	BOTSWANA
BLVD	BOULEVARD
BOUND	BOUNDARY
BOUND	BOUNDRY
BOURNEM	BOURNEMOUTH
BOWHUNT	BOWHUNT
BOWL	BOWLING
BOX	BOXING
BOYCOTT	BOYCOTT
BRADF	BRADFORD
BRADSTR	BRADSTRET
BRAID	BRAIDING
BRANCH	BRANCHING
BRANCHL	BRANCHLINE
BRAZ	BRAZIL
BREAK	BREAK
BREAKF	BREAKFAST
BREAKTHR	BREAKTHROUGH
BREASTFEED	BREASTFEEDING
BREATH	BREATHING
BREECHLOAD	BREECHLOADING
BREED	BREEDER
BREED	BREEDING
BRETHR	BRETHREN
BREW	BREWER
BREW	BREWING
BRICKLAY	BRICKLAY
BRIDG	BRIDG
BRIDGET	BRIDGETOWN
BRIDGEW	BRIDGEWATER
BRIEFC	BRIEFCASE
BRIEF	BRIEFING
BRIGH	BRIGHAM
BRIGHT	BRIGHT
BRILL	BRILLANT
BRILL	BRILLIAN
BRIQUET	BRIQUETTING
BRISB	BRISBANE
BR	BRITAIN
BR	BRITISH
BC	BRITISH COLUMBIA
BROADCAST	BROADCAST
BROADSH	BROADSHEET
BROADS	BROADSIDE
BROCKP	BROCKPORT
BROCKV	BROCKVILLE
BROK	BROKER
BROK	BROKERAGE
BROK	BROKING
BROMEL	BROMELI
BRONCHOL	BRONCHOLOGY
BRONXV	BRONXVILLE
BROOK	BROOKING
BROTHER	BROTHER
BROWS	BROWS
BRUNSW	BRUNSWICK
BRUSHMAK	BRUSHMAK
BRUSS	BRUSSELS
BRYOECOL	BRYOECOLOGY
BRYOZOOL	BRYOZOOLOGY
BUCCAN	BUCCANER
BUCHAR	BUCHAREST
BUCK	BUCKINGHAM
BUCKS	BUCKINGHAMSHIRE
BUCKMAST	BUCKMASTER
BUDDH	BUDDHIST
BUDGER	BUDGERIGAR
BUDG	BUDGET
BUDG	BUDGETARY
BUDG	BUDGETING
BUG	BUGGY
BUILD	BUILDER
BUILD	BUILDING
BULG	BULGAR
BULK	BULKING
BUMP	BUMP
BURD	BURDEN
BURLINGT	BURLINGTON
BURN	BURN
BURS	BURSARY
BUSHWALK	BUSHWALK
BUSHWHACK	BUSHWHACK
BUS	BUSINESS
BUSINESSM	BUSINESSMAN
BUTCH	BUTCHER
BUTL	BUTLER
BUTTON	BUTTONEER
BUY	BUYABLE
BUY	BUYER
BUY	BUYING
BYELORUSS	BYELORUSSIAN
BYPROD	BYPRODUCT
CABINETMAK	CABINETMAKING
CALAM	CALAMIT
CALCIF	CALCIFICATION
CALC	CALCUL
CALED	CALEDONIAN
CAL	CALENDAR
CALG	CALGARY
CALIF	CALIFORNIA
CALIOL	CALIOLOGIST
CALISTHEN	CALISTHEN
CALLB	CALLBOOK
CALL	CALLED
CALLIGR	CALLIGRAPHY
CALL	CALLING
CALORIM	CALORIMETRY
CALVIN	CALVINISM
CAMBODG	CAMBODGI
CAMBR	CAMBRIAN
CAMB	CAMBRIDGE
CAMBS	CAMBRIDGESHIRE
CAMCORD	CAMCORDER
CAMOUFL	CAMOUFLAGE
CAMPAIGN	CAMPAIGN
CAN	CANADA
CAN	CANADI
CANALIZ	CANALIZATION
CANCEL	CANCEL
CANCEROL	CANCEROLOGY
CANCROL	CANCROLOGY
CANEGROW	CANEGROWER
CANMAK	CANMAKER
CANMAK	CANMAKING
CANN	CANNED
CANN	CANNER
CANN	CANNING
CANOE	CANOE
CANOESP	CANOESPORT
CANTERB	CANTERBURY
CANVEY ISL	CANVEY ISLAND
CAPAB	CAPABILITY
CAPILL	CAPILLARY
CAP	CAPITAL
CAPSUL	CAPSUL
CAPT	CAPTAIN
CAPTIV	CAPTIV
CARBOCAT	CARBOCATION
CARBOCYCL	CARBOCYCLIC
CARBOHYDR	CARBOHYDRATE
CARBONIF	CARBONIFEROUS
CARBUR	CARBURANT
CARCINOG	CARCINOGEN
CARDIOANGIOL	CARDIOANGIOLOGY
CARDIOCIRC	CARDIOCIRCULATION
CARDIOGR	CARDIOGRAPHY
CARDIOL	CARDIOLOGY
CARDIOPROT	CARDIOPROTECTI
CARDIOPULM	CARDIOPULMONARY
CARDIORESPIR	CARDIORESPIRAT
CARDIOTHORAC	CARDIOTHORACIC
CARDIOVASC	CARDIOVASC
CAREGIV	CAREGIVER
CARIBB	CARIBBEAN
CARIOL	CARIOLOGY
CARLET	CARLETON
CARMARTHENS	CARMARTHENSHIRE
CARNAT	CARNATION
CARNIV	CARNIVOR
CARNOISS	CARNOISSEUR
CAROL	CAROLINA
CARPENT	CARPENTER
CARPET	CARPETING
CARPINT	CARPINTER
CARR	CARRIER
CARR	CARRYING
CARTES	CARTESIAN
CARTIL	CARTILAGE
CARTOGR	CARTOGRAPHY
CARTOON	CARTOON
CASH	CASHED
CASINGH	CASINGHEAD
CASP	CASPIAN
CASTELL	CASTELLANO
CAST	CASTING
CATAL	CATALYSIS
CATAL	CATALYT
CATASTR	CATASTROPHISM
CATCH	CATCHING
CATECH	CATECHIST
CATEG	CATEGORY
CATER	CATER
CATERP	CATERPILLAR
CATHAR	CATHAR
CATH	CATHARINE
CATHEDR	CATHEDRAL
CATHETER	CATHETER
CATHOL	CATHOLI
CATONSV	CATONSVILLE
CATTLEM	CATTLEMAN
CATTLEW	CATTLEWOMAN
CAUC	CAUCASIAN
CAUC	CAUCASUS
CAUFLD	CAUFIELD
CAULIFL	CAULIFLOWER
CAUSEW	CAUSEWAY
CECHOSLOV	CECHOSLOV
CECIDIOL	CECIDIOLOGY
CEDARV	CEDARVILLE
CEIL	CEILING
CELEST	CELESTIAL
CELL	CELLULA
CELL	CELLULE
CELLUL	CELLULOS
CEM	CEMENT
CEMET	CEMETRY
CENSORSH	CENSORSHIP
CENTEN	CENTEN
CENT	CENTER
CENTRAFR	CENTRAFRIC
CENTRIF	CENTRIFUGAL
CEPHALOP	CEPHALOPOD
CERAM	CERAMIC
CEREB	CEREBRAL
CEREBROVASC	CEREBROVASCULAR
CEREM	CEREMON
CERTAIN	CERTAIN
CERTIF	CERTIFICAT
CERTIF	CERTIFIED
CERV	CERVICAL
CERVICOFAC	CERVICOFACIAL
CESSAT	CESSATION
CHAIRM	CHAIRMAN
CHALL	CHALLENGE
CHALL	CHALLENGER
CHAMB	CHAMBER
CHAMBERSBG	CHAMBERSBURG
CHANCELL	CHANCELLER
CHANCELL	CHANCELLOR
CHANDL	CHANDLER
CHAPB	CHAPBOOK
CHAP HILL	CHAPEL HILL
CHAPELT	CHAPELTOWN
CHAPLAIN	CHAPLAIN
CHARACT	CHARACTERIZATION
CHARACT	CHARACTERISTIC
CHARLEST	CHARLESTON
CHARLOTTESV	CHARLOTTESVILLE
CHARLOTTET	CHARLOTTETOWN
CHART	CHARTER
CHART	CHARTERED
CHAS	CHASING
CHAST	CHASTITY
CHATT	CHATTANOOGA
CHAUNC	CHAUNCEY
CHECKL	CHECKLIST
CHECKP	CHECKPOINT
CHELMSF	CHELMSFORD
CHELTEN	CHELTENHAM
CHEM	CHEMIC
CHEMIGR	CHEMIGRAPHY
CHEMILUMIN	CHEMILUMINESCEN
CHEMISORPT	CHEMISORPTION
CHEM	CHEMISTRY
CHEM	CHEMIZ
CHEMOM	CHEMOMETER
CHEMON	CHEMONOMIC
CHEMORECEPT	CHEMORECEPT
CHEMORHEOL	CHEMORHEOLOGY
CHEMOSENS	CHEMOSENSOR
CHEMOSYST	CHEMOSYSTEM
CHEMOTAXON	CHEMOTAXONOM
CHEMOTHER	CHEMOTHERAP
CHEMURG	CHEMURG
CHEROK	CHEROKEE
CHERUB	CHERUBI
CHESAP	CHESAPEAKE
CHES	CHESHIRE
CHESSPLAY	CHESSPLAY
CHESTERV	CHESTERVILLE
CHIC	CHICAGO
CHICK	CHICKEN
CHILDBEAR	CHILDBEAR
CHILD	CHILDHOOD
CHILDREAR	CHILDREAR
CHILD	CHILDREN
CHIL	CHILEAN
CHILL	CHILL
CHIN	CHINESE
CHIROP	CHIROPOD
CHIROPR	CHIROPRACTIC
CHIROPR	CHIROPRACTOR
CHIROPT	CHIROPTERA
CHIR	CHIRURG
CHOC	CHOCOLAT
CHOICEL	CHOICELAND
CHOOS	CHOOSING
CHOP	CHOPPER
CHORIST	CHORISTER
CHOWD	CHOWDER
CHRISTADELPH	CHRISTADELPHIAN
CHRISTCH	CHRISTCHURCH
CHRISTOL	CHRISTOLOGY
CHRIST	CHRISTORIUM
CHROMATOGR	CHROMATOGRAPHY
CHROMOSPH	CHROMOSPHERE
CHRON	CHRONICLE
CHRONOBIOTECHNOL	CHRONOBIOTECHNOLOGY
CHRONOM	CHRONOMETER
CHRONOPHARMACOL	CHRONOPHARMACOLOGY
CHRONOSTRATIGR	CHRONOSTRATIGRAPHIC
CHRONOTHER	CHRONOTHERAP
CHRYSAL	CHRYSALIS
CHRYSANTH	CHRYSANTH
CHURCHM	CHURCHMAN
CIBERN	CIBERNETIC
CINE	CINEMA
CINEMATOGR	CINEMATOGRAPHY
CINERADIOGR	CINERADIOGRAPHY
CIRC	CIRCLE
CIRCUMST	CIRCUMSTANCE
CIT	CITATION
CITIZ	CITIZEN
CITIZSH	CITIZENSHIP
CITOGR	CITOGRAPHY
CITOL	CITOLOGY
CITRIC	CITRICULT
CITROGR	CITROGRAPHY
CITROL	CITROLOGY
CIV	CIVIC
CIV	CIVIL
CIV	CIVILIAN
CIVILIS	CIVILISED
CIVILIS	CIVILISING
CIVILIZ	CIVILIZATION
CIV	CIVILS
CLACKMANNANS	CLACKMANNANSHIRE
CLAR	CLARION
CL	CLASS
CL	CLASSE
CLASS	CLASSIC
CLASSIF	CLASSIFICATION
CLASSR	CLASSROOM
CLAYWORK	CLAYWORKER
CLEAN	CLEANER
CLEAN	CLEANING
CLEAN	CLEANSING
CLEAR	CLEAR
CLEAR	CLEARANCE
CLGH	CLEARINGHOUSE
CLEETH	CLEETHORPES
CLERIC	CLERICAL
CLEVEL	CLEVELAND
CLIM	CLIMAT
CLIMATOL	CLIMATOLOGY
CLIMB	CLIMBER
CLIN	CLINIC
CLINT	CLINTON
CLIPP	CLIPPER
CLIPP	CLIPPING
CLOCKMAK	CLOCKMAK
CLOCKW	CLOCKWISE
CLOS	CLOSURE
CLOTH	CLOTHIER
CLOTH	CLOTHING
CLOTHWORK	CLOTHWORKER
CLOTT	CLOTTING
CLUBH	CLUBHOUSE
CLUBL	CLUBLAND
CLUST	CLUSTER
COOP	COOPERATIVE
COORD	COORDINATION
COACH	COACH
COALF	COALFIELD
COAST	COASTAL
COAT	COATED
COAT	COATING
COCARCINOG	COCARCINOGEN
COERC	COERC
COEVOL	COEVOLUTION
COGENER	COGENERATION
COGN	COGNATE
COGNIZ	COGNIZ
COHES	COHESION
COIN	COINAGE
COINHUNT	COINHUNTER
COKEMAK	COKEMAKING
COLCH	COLCHESTER
COLECT	COLECTION
COLEOPT	COLEOPTER
COLEOPTEROL	COLEOPTEROLOGY
COLLAB	COLLABORATION
COLLECT	COLLECT
COLL	COLLEGE
COLL	COLLEGI
COLLID	COLLIDER
COLLIS	COLLISION
COLON	COLONI
COLO	COLORADO
COLO SPRINGS	COLORADO SPRINGS
COLOTM	COLOTOMY
COLOUR	COLOURAGE
COLOUR	COLOURING
COLOUR	COLOURIST
COLPOSC	COLPOSCOP
COLUMB	COLUMBUS
COMB	COMBINATION
COMBUST	COMBUSTION
COMER	COMERCI
COMF	COMFORT
COMMEM	COMMEMORANT
COMMEM	COMMEMORAT
COMMENC	COMMENC
COMMENT	COMMENTAR
COMMER	COMMERC
COMMIS	COMMISSAR
COMM	COMMISSION
COMMIT	COMMITMENT
COMM	COMMITTEE
COMMOD	COMMODIT
COMMON	COMMONER
COMMONW	COMMONWEALTH
COMMUN	COMMUNICATION
COMMUT	COMMUT
COMPACT	COMPACT
CO	COMPANIES
CO	COMPANY
COMP	COMPARA
COMP	COMPARE
COMP	COMPARI
COMPAT	COMPATIBIL
COMPEND	COMPEND
COMPENS	COMPENSAT
COMPET	COMPETING
COMPET	COMPETIT
COMPIL	COMPIL
COMPLAIN	COMPLAIN
COMPLET	COMPLET
COMPLEX	COMPLEXITY
COMPLICAT	COMPLICAT
COMPLIM	COMPLIMENT
COMPLIMENT	COMPLIMENTARY
COMPON	COMPONENT
COMPOS	COMPOS
COMPOST	COMPOST
COMPD	COMPOUND
COMPR	COMPREHENSIVE
COMPRESS	COMPRESSED
COMPRESS	COMPRESSOR
COMPTROL	COMPTROL
COMPULS	COMPULSIVE
COMPULS	COMPULSORY
COMPUT	COMPUTATION
COMPUTERL	COMPUTERLAND
COMPUTERV	COMPUTERVISION
COMUN	COMUNICATION
CONCEPT	CONCEPTUAL
CONCEPT	CONCEPTION
CONCERN	CONCERNING
CONCHOL	CONCHOLOGY
CONCHYLIOL	CONCHYLIOLOGY
CONCIL	CONCILIATION
CONCIL	CONCILIATOR
CONCLUS	CONCLUSION
CONCORD	CONCORDANCE
CONCR	CONCRETE
CONDENS	CONDENS
COND	CONDITION
CONDOM	CONDOMINIUM
CONDUC	CONDUCIVE
CONFECT	CONFECTION
CONFED	CONFEDERA
CONF	CONFERENCECE
CONFERR	CONFERR
CONFESS	CONFESSIONAL
CONFID	CONFIDENCE
CONFID	CONFIDENTIAL
CONFISC	CONFISCATION
CONFL	CONFLICT
CONFLU	CONFLUENCE
CONFRATERN	CONFRATERNITY
CONFRONT	CONFRONTATION
CONGENIT	CONGENITAL
CONGLOM	CONGLOMERATE
CONGREGAT	CONGREGATION
CONGR	CONGRESS
CONIFER	CONIFEROUS
CONN	CONNECTICUT
CONNECT	CONNECTION
CONNECT	CONNECTIVE
CONNECT	CONNECTOR
CONNOISS	CONNOISSEUR
CONQU	CONQUERING
CONQU	CONQUEST
CONSCIOUS	CONSCIOUSNESS
CONSID	CONSIDERATION
CONSID	CONSIDERED
CONSIST	CONSISTING
CONSOL	CONSOLIDATION
CONSOMM	CONSOMM
CONSPIR	CONSPIR
CONSTABUL	CONSTABULARY
CONSTANTIN	CONSTANTINIAN
CONSTELL	CONSTELLATION
CONST	CONSTITUTION
CONST	CONSTITUTION
CONSTR	CONSTRUCTION
CONSUL	CONSULAR
CONSULT	CONSULTATION
CONSUM	CONSUMPTION
CONTAIN	CONTAIN
CONTAM	CONTAMINA
CONTEMP	CONTEMPORY
CONTEND	CONTEND
CONT	CONTINENCE
CONT	CONTINENT
CONTING	CONTINGENCY
CONTING	CONTINGENT
CONTRACEPT	CONTRACEPTION
CONTRACEPT	CONTRACEPTIVE
CONTRACT	CONTRACT
CONTRAR	CONTRAR
CONTROL	CONTROL
CONTROV	CONTROV
CONURBAT	CONURBATION
CONVAL	CONVALESCENT
CONVECT	CONVECTION
CONVENTIONL	CONVENTIONLAND
CONVERSAT	CONVERSATION
CONVERS	CONVERSION
CONVERT	CONVERT
CONVEY	CONVEYANC
CONVICT	CONVICTION
CONVOC	CONVOCATION
COOKB	COOKBOOK
COOK	COOKERY
COOK	COOKING
COOL	COOL
COOP	COOPERA
CPH	COPENHAGEN
COPOLYM	COPOLYMER
COPP	COPPER
COPROD	COPRODUCTION
COPT	COPTIC
COPYR	COPYRIGHT
CORINTH	CORINTHIAN
CORMOR	CORMORANT
CORNEL	CORNELIAN
CORN	CORNISH
CORN	CORNWALL
CORON	CORONARY
CORP	CORPORAT
CORPOR	CORPOREAL
CORPUSC	CORPUSCULA
CORRECT	CORRECTION
CORRECT	CORRECTIVE
CORREL	CORRELATION
CORRESP	CORRESPONDING
CORROS	CORROSIVE
CORRUGAT	CORRUGATED
COSMET	COSMETI
COSMETOL	COSMETOLOGY
COSMOCHEM	COSMOCHEMISTRY
COSMOCHRONOL	COSMOCHRONOLOGY
COSMOL	COSMOLOGY
COSMOPHOB	COSMOPHOBIA
COTTAG	COTTAG
COULOM	COULOMETER
COUNC	COUNCELLING
COUNC	COUNCIL
COUNS	COUNSEL
COUNT	COUNTER
COUNTERMEAS	COUNTERMEASUR
COUNTERTR	COUNTERTRADE
CTIES	COUNTIES
COUNT	COUNTING
CTRIES	COUNTRIES
CTRY	COUNTRY
COUNTRYM	COUNTRYMAN
COUNTRYS	COUNTRYSIDE
COUNTRYW	COUNTRYWIDE
CTY	COUNTY
COUR	COURIER
COURSEW	COURSEWARE
COURT	COURT
COURTH	COURTHOUSE
COVENANT	COVENANT
COVER	COVER
CRACK	CRACKED
CRACK	CRACKING
CRAFTSM	CRAFTSMAN
CRAFTWORK	CRAFTWORK
CRANIOMANDIB	CRANIOMANDIBULAR
CREAM	CREAMERY
CREDIBIL	CREDIBILITY
CRETAC	CRETACEOUS
CRETIN	CRETINISM
CRICKET	CRICKETER
CRIME	CRIMEAN
CRIM	CRIMINAL
CRIMINOL	CRIMINOLOGY
CRIPPL	CRIPPL
CRIPTOGAM	CRIPTOGAMI
CRIT	CRITIC
CRIT	CRITICI
CROAK	CROAKER
CROAT	CROATIA
CROFT	CROFTER
CROP	CROP
CROSSBREED	CROSSBREEDING
CROSSCURR	CROSSCURRENT
CROSSLINK	CROSSLINKING
CRUCIB	CRUCIBLE
CRUEL	CRUELTY
CRUIS	CRUISING
CRUSAD	CRUSADER
CRUSAD	CRUSADING
CRUSH	CRUSHER
CRUSH	CRUSHING
CRYOBIOL	CRYOBIOLOGY
CRYOENG	CRYOENGINEER
CRYOG	CRYOGENI
CRYOPHYS	CRYOPHYSICS
CRYOPRESERV	CRYOPRESERV
CRYPTANTH	CRYPTANTHUS
CRYPTOGAM	CRYPTOGAMI
CRYPTOGR	CRYPTOGRAPHY
CRYPTOL	CRYPTOLOGY
CRYST	CRYSTAL
CRYST	CRYSTALLI
CRYSTALLOCHEM	CRYSTALLOCHEMISTRY
CRYSTALLOGR	CRYSTALLOGRAPHY
CRYST	CRYSTALS
CUBA	CUBA
CULIN	CULINARY
CULTIV	CULTIV
CULT	CULTURE
CUMBERL	CUMBERLAND
CUMUL	CUMULAT
CUNEIF	CUNEIFORM
CURATOR	CURATORIAL
CURIOSIT	CURIOSIT
CURL	CURLER
CURL	CURLING
CURMUDG	CURMUDGEON
CURR	CURRENCY
CURR	CURRENT
CURRIC	CURRICULAR
CUSTOD	CUSTODIAL
CUST	CUSTOM
CUTAN	CUTANEOUS
CUT	CUTTER
CUT	CUTTING
CYBERN	CYBERNETICS
CYCL	CYCLIC
CYCL	CYCLING
CYCL	CYCLIST
CYCLOADDIT	CYCLOADDITI
CYCLODEXT	CYCLODEXTRIN
CYCLOP	CYCLOPAEDIA
CYCLOR	CYCLORAMA
CYCLOST	CYCLOSTYLED
CYCLOTR	CYCLOTRON
CYLIND	CYLIND
CYST	CYSTIC
CYTOBIOL	CYTOBIOLOGY
CYTOCHEM	CYTOCHEM
CYTODIAGN	CYTODIAGNOS
CYTOEMBRYOL	CYTOEMBRYOLOGY
CYTOGENET	CYTOGENET
CYTOL	CYTOLOGY
CYTOM	CYTOMETER
CYTOPATHOL	CYTOPATHOLOGY
CYTOPHARMACOL	CYTOPHARMACOLOGY
CYTOPHOTOM	CYTOPHOTOMETER
CYTOPROT	CYTOPROTECT
CYTOREDUCT	CYTOREDUCTION
CYTOSKELET	CYTOSKELET
CYTOTOX	CYTOTOXICITY
CZECHOSLOV	CZECHOSLOV
DLY	DAILY
DAIRYFARM	DAIRYFARMING
DAIRY	DAIRYING
DAIRYL	DAIRYLAND
DAIRYM	DAIRYMAN
DAK	DAKOTA
DALESM	DALESMAN
DALHOUS	DALHOUSIE
DANC	DANCER
DANC	DANCING
DAN	DANEMARK
DANGER	DANGEROUS
DAN	DANISH
DANSV	DANSVILLE
DAO	DAOISM
DARKN	DARKNESS
DARTM	DARTMOUTH
DATAUPP	DATAUPPER
DATAB	DATABOOK
DATAF	DATAFILE
DATAM	DATAMAIL
DATAMAT	DATAMATIC
DATAMAT	DATAMATION
DATAPT	DATAPOINT
DATAREV	DATAREVIEW
DATASYST	DATASYSTEM
DATEB	DATEBOOK
DAYT	DAYTON
DAYT BEACH	DAYTONA BEACH
DAYW	DAYWORKS
DEACTIV	DEACTIVA
DEAF	DEAF
DEAL	DEAL
DEBENT	DEBENTURE
DEBT	DEBTOR
DECANT	DECANTER
DEC	DECEMBER
DECENN	DECENNIAL
DECEPT	DECEPTION
DECERTIF	DECERTIFICATION
DECIM	DECIMAL
DECIS	DECISION
DECLAR	DECLARA
DECLASSIF	DECLASSIFIED
DECLIN	DECLINING
DECOMPOS	DECOMPOSITION
DECONTAM	DECONTAMINAT
DECOR	DECORATING
DECOR	DECORATION
DECOR	DECORATIVE
DECOR	DECORATOR
DECORP	DECORPORAT
DEDIC	DEDICATED
DEDUC	DEDUCTION
DEEP	DEEP
DEERBREED	DEERBREEDER
DEF	DEFENCE
DEF	DEFENDER
DEF	DEFENSE
DEFIC	DEFICIENCE
DEFIN	DEFIN
DEFRAY	DEFRAY
DEGENER	DEGENERATION
DEGRAD	DEGRADATION
DEL	DELAWARE
DELIC	DELICIOUS
DELIV	DELIVER
DEMINER	DEMINERALI
DEMOCR	DEMOCRA
DEN	DENMARK
DENOMINAT	DENOMINATOR
DENSIF	DENSIFICATION
DENSITOM	DENSITOMETER
DENT	DENTA
DENT	DENTIST
DENTOFAC	DENTOFACIAL
DENT	DENTURIST
DEP	DEPARTMENT
DEPART	DEPARTURE
DEPEND	DEPENDENT
DEPLET	DEPLETION
DEPLOY	DEPLOYMENT
DEPOS	DEPOSIT
DEPOS	DEPOSITOR
DEPOS	DEPOSITORY
DEPRECIAT	DEPRECIATION
DEPRESS	DEPRESS
DERBYS	DERBYSHIRE
DEREGUL	DEREGULATION
DEREL	DERELICT
DERIV	DERIVA
DERIV	DERIVE
DERMAT	DERMATITIS
DERMATOPATHOL	DERMATOPATHOLOGY
DERMATOPHARMACOL	DERMATOPHARMACOLOGY
DERMATOTOXIC	DERMATOTOXICOLOGY
DESALT	DESALT
DESCR	DESCRIB
DESCR	DESCRIPTION
DESCR	DESCRIPTOR
DESEGREG	DESEGREG
DES	DESIGN
DESIGNB	DESIGNBOOK
DESKB	DESKBOOK
DESKT	DESKTOP
DESTR	DESTRUCTION
DESTR	DESTRUCTOR
DETAIL	DETAILED
DETECT	DETECTION
DETEN	DETENTION
DETERG	DETERGEN
DETERM	DETERMINATION
DETOXIF	DETOXIFICAT
DEV	DEVELOPMENT
DEVIAT	DEVIATION
DEVON	DEVONSHIRE
DEVOT	DEVOTION
DEVOT	DEVOTIONAL
DECAD	DECAD
DIABET	DIABETIC
DIACYCLGLYC	DIACYCLGLYCEROLS
DIAET	DIAETETI
DIAGR	DIAGRAM
DIALECT	DIALECTICAL
DIALECTR	DIALECTRIC
DIAM	DIAMOND
DIANET	DIANETIC
DIATH	DIATHESIS
DICT	DICTIONARY
DIDACT	DIDACTICS
DIDAKOM	DIDAKOMETRY
DIELECTR	DIELECTRIC
DIELECTROPHOR	DIELECTROPHORE
DIET	DIETARY
DIETIT	DIETITIAN
DIFFER	DIFFERENCE
DIFFIC	DIFFICULTY
DIFFR	DIFFRACTION
DIFFRACTOM	DIFFRACTOMETER
DIG	DIGEST
DIHYDROXYVITAM	DIHYDROXYVITAMIN
DILIG	DILIGENCE
DIMENS	DIMENSION
DINN	DINNER
DINOFLAG	DINOFLAGELLAT
DINOSAUR	DINOSAUR
DIOC	DIOCESAN
DIPL	DIPLOMACY
DIPTER	DIPTERIST
DIR	DIRECTED
DIR	DIRECTI
DIR	DIRECTOR
DISABIL	DISABILIT
DISABL	DISABLED
DISACCH	DISACCHARIDE
DISADV	DISADVANTAGE
DISARM	DISARM
DISBURSE	DISBURSEMENT
DISCERN	DISCERNING
DISCH	DISCHARGE
DISCIPL	DISCIPLINEE
DISCIPLESH	DISCIPLESHIP
DISCIP	DISCIPLINE
DISCL	DISCLOSURE
DISCOGR	DISCOGRAPHY
DISCONTIN	DISCONTINUED
DISCOUNT	DISCOUNT
DISCOV	DISCOVER
DISCRET	DISCRET
DISCUSS	DISCUSSION
DIS	DISEASE
DISINFECT	DISINFECT
DISMISS	DISMISSAL
DISORD	DISORDER
DISPAR	DISPARITION
DISPENS	DISPENS
DISPETCHER	DISPETCHERIZ
DISPLAC	DISPLACEMENT
DISP	DISPLAY
DISPON	DISPONIB
DISPOS	DISPOSAL
DISPOS	DISPOSIT
DISRUPT	DISRUPTION
DISSEM	DISSEMINATION
DISSENT	DISSENTING
DISS	DISSERTA
DISTILL	DISTILL
DISTINCT	DISTINCTION
DISTING	DISTINGUISH
DC	DISTRICT OF COLUMBIA
DIST	DISTRICT
DISTURB	DISTURBANCE
DISTURB	DISTURBED
DIURET	DIURETIC
DIVERS	DIVERS
DIVERSIF	DIVERSIFICATION
DIVEST	DIVEST
DIVID	DIVID
DIVIN	DIVINITY
DIV	DIVIS
DOCKL	DOCKLANDS
DR	DOCTOR
DOLLARW	DOLLARWISE
DOMEST	DOMESTICATION
DOMINIC	DOMINICAN
DOM	DOMINION
DOODL	DOODL
DORK	DORKING
DOUBT	DOUBT
DOWNL	DOWNLAND
DOWNSCAL	DOWNSCAL
DOWNSTR	DOWNSTREAM
DOWNT	DOWNTOWN
DOZEN	DOZENAL
DRAFT	DRAFT
DRAIN	DRAINER
DRAM	DRAMATI
DRAMATURG	DRAMATURG
DRAUGHT	DRAUGHT
DRAUGHT	DRAUGHTING
DRAVID	DRAVIDIC
DRAW	DRAW
DRAYT	DRAYTON
DREAM	DREAMER
DREAMWEAV	DREAMWEAVER
DREDG	DREDGER
DREDG	DREDGING
DRESS	DRESSING
DRIFT	DRIFTING
DRILL	DRILLED
DRILL	DRILLING
DRINK	DRINK
DRIV	DRIVER
DRIV	DRIVING
DROUGHTSTRICK	DROUGHTSTRICKEN
DRUG	DRUGGIST
DRUGTHER	DRUGTHERAPY
DRUMHELL	DRUMHELLER
DRYCLEAN	DRYCLEANER
DRY	DRYER
DRY	DRYING
DUMBART	DUMBARTON
DUMFRIES	DUMFRIESSHIRE
DUMP	DUMPING
DUNED	DUNEDIN
DURAB	DURABILITY
DURAT	DURATION
DURB	DURBAN
DURH	DURHAM
DUR	DURING
DIVERSIF	DVERSIF
DWELL	DWELLING
DYE	DYE
DYEST	DYESTUFF
DYN	DYNAMIC
DYNAM	DYNAMIC
DYSENT	DYSENTERY
DYSFUNCT	DYSFUNCTION
DYSMORPHOL	DYSMORPHOLOGY
EARN	EARNER
EARN	EARNING
EARTHQ	EARTHQUAKE
EAST	EASTERN
EASTL	EASTLAND
EAT	EATING
ECCLES	ECCLESIAST
ECHOCARDIOGR	ECHOCARDIOGRAPHY
ECLECT	ECLECTIC
ECLIPS	ECLIPSING
ECOBIOL	ECOBIOLOGY
ECOGEOGR	ECOGEOGRAPHY
ECOHYDROL	ECOHYDROLOGY
ECOL	ECOLOGY
ECOMATER	ECOMATERIA
ECON	ECONOMY
ECOPHYSIOL	ECOPHYSIOLOGY
ECOSYST	ECOSYSTEM
ECOTEXT	ECOTEXTIL
ECOTOXICOL	ECOTOXICOLOGY
ECOTUR	ECOTURISM
ECUAT	ECUATOR
ECUM	ECUMENICAL
EDINB	EDINBURGH
ED	EDIT
EDITOR	EDITORIAL
EDMONT	EDMONTON
EDUC	EDUCATION
EDUCOL	EDUCOLOGY
EDW	EDWARD
EFF	EFFECT
EFFIC	EFFICIENCY
EFFL	EFFLUENT
EGANV	EGANVILLE
EGLINT	EGLINTON
EGREG	EGREGIOUS
EGYPT	EGYPTIAN
EGYPTOL	EGYPTOLOGY
EINDH	EINDHOVEN
EJECT	EJECTOR
ELAST	ELASTICITY
ELASTOHYDRODYN	ELASTOHYDRODYNAMI
ELB	ELBOW
ELDER	ELDERLY
ELECT	ELECTED
ELECT	ELECTIVE
ELECT	ELECTORAL
ELECTR	ELECTRIC
ELECTROACT	ELECTROACTIV
ELECTROANAL	ELECTROANALY
ELECTROANESTH	ELECTROANESTHES
ELECTROCARDIOGR	ELECTROCARDIOGRAPHY
ELECTROCARDIOL	ELECTROCARDIOLOGY
ELECTROCHEM	ELECTROCHEMISTRYC
ELECTROCHEMOTHER	ELECTROCHEMOTHERAP
ELECTROCHROMATOGR	ELECTROCHROMATOGRAPHY
ELECTROCOMPON	ELECTROCOMPONENT
ELECTRODEPOS	ELECTRODEPOSITION
ELECTRODEPOS	ELECTRODEPOSITOR
ELECTRODIAGN	ELECTRODIAGNOSTIC
ELECTRODYN	ELECTRODYNAMICS
ELECTROENCEPHALOGR	ELECTROENCEPHALOGRAPHY
ELECTROENERG	ELECTROENERGET
ELECTROEXPLOS	ELECTROEXPLOSIVE
ELECTROGENETHER	ELECTROGENETHERAP
ELECTROKINET	ELECTROKINETI
ELECTROL	ELECTROLOGY
ELECTROMAGN	ELECTROMAGNETISM
ELECTROMED	ELECTROMEDIC
ELECTROMETALL	ELECTROMETALLURGY
ELECTROMIGR	ELECTROMIGRATI
ELECTROMYOGR	ELECTROMYOGRAPHY
ELECTRON	ELECTRONICSC
ELECTRONMICROSC	ELECTRONMICROSCOP
ELECTROORG	ELECTROORGANI
ELECTROPHOR	ELECTROPHORE
ELECTROPHYSIOL	ELECTROPHYSIOLOGY
ELECTROPLAT	ELECTROPLAT
ELECTROREFIN	ELECTROREFINING
ELECTROST	ELECTROSTATIC
ELECTROTECH	ELECTROTECHNIS
ELECTROTECHNOL	ELECTROTECHNOLOGY
ELECTROTHER	ELECTROTHERAP
ELECTROTHERM	ELECTROTHERMAL
ELEM	ELEMENT
ELIG	ELIGIBLE
ELIMIN	ELIMINATION
ELIZAB	ELIZABETH
ELIZAB	ELIZABETHAN
ELMB	ELMBRIDGE
ELMW	ELMWOOD
ELUS	ELUSIVE
ENGJ	ENGINEERING JOURNAL
ENGINEER	ENGINEERING
EMANCIP	EMANCIPATION
EMBED	EMBEDED
EMBL	EMBLEMATIC
EMBRAC	EMBRACING
EMERG	EMERGENCY
EMERG	EMERGING
EMERYV	EMERYVILLE
EMIR	EMIRAT
EMISS	EMISSION
EMIT	EMIT
EMOL	EMOLUMENT
EMOT	EMOTION
EMPATH	EMPATHIC
EMPHAS	EMPHASIS
EMP	EMPIRE
EMPIR	EMPIRICAL
EMPLOYAB	EMPLOYABILITY
EMPLOY	EMPLOYED
EMPL	EMPLOYEE
EMPL	EMPLOYER
EMPLOY	EMPLOYMENT
EMPOWER	EMPOWER
EMPOWER	EMPOWERING
ENACTM	ENACTMENT
ENAMEL	ENAMELIST
ENAMEL	ENAMELLING
ENCAMP	ENCAMP
ENCEPH	ENCEPH
ENCLOS	ENCLOSURE
ENCOUNT	ENCOUNT
ENCYCL	ENCYCLOP
ENDANGER	ENDANGERED
ENDEAV	ENDEAVOUR
END	ENDED
END	ENDING
ENDOCR	ENDOCRINE
ENDOCRINOL	ENDOCRINOLOGY
ENDOCRINOPAT	ENDOCRINOPATHY
ENDOCYTOBIOL	ENDOCYTOBIOLOGY
ENDOD	ENDODONTIC
ENDOMETR	ENDOMETRIOSIS
ENDOSC	ENDOSCOP
ENDOW	ENDOWMENT
ENERG	ENERGISTIC
ENERGOCHEM	ENERGOCHEMIC
ENFORC	ENFORCEMENT
ENFORC	ENFORCER
ENFORC	ENFORCING
ENGAGEM	ENGAGEMENT
ENG	ENGINEERING
ENGL	ENGLAND
ENGL	ENGLISH
ENGRAV	ENGRAVER
ENGRAV	ENGRAVING
ENHANC	ENHANCE
ENLARG	ENLARGEMENT
ENLIGHT	ENLIGHTENED
ENLIGHT	ENLIGHTENMENT
ENNEAGR	ENNEAGRAM
ENQ	ENQUIRY
ENRICH	ENRICHMENT
ENROLL	ENROLLED
ENROLL	ENROLLMENT
ENROL	ENROLMENT
ENTER	ENTERAL
ENTER	ENTERING
ENTEROBACT	ENTEROBACTERI
ENTEROS	ENTEROSTOMAL
ENTERP	ENTERPRENEUR
ENTERP	ENTERPRISE
ENTERTAIN	ENTERTAIN
ENTHUS	ENTHUSIAST
ENTOMOPATHOG	ENTOMOPATHOGEN
ENTR	ENTRANCE
ENTROPH	ENTROPHICATION
ENTRUST	ENTRUST
ENUMER	ENUMERATION
ENUMER	ENUMERATIVE
ENVIROANAL	ENVIROANALY
ENVIRON	ENVIRONMENT
ENVIS	ENVISION
ENWISDOMIZ	ENWISDOMIZATION
ENZYM	ENZYM
ENZYMOCHEM	ENZYMOCHEM
EPHEMER	EPHEMER
EPICUR	EPICUR
EPILEPTOG	EPILEPTOGEN
EPIOPT	EPIOPTIC
EPISCOP	EPISCOPAL
EPITHEL	EPITHELIAL
EPONYM	EPONYMIST
EQUAL	EQUAL
EQU	EQUATION
EQUAT	EQUATOR
EQUEST	EQUESTRIAN
EQUILIB	EQUILIBRIUM
EQUIP	EQUIPMENT
EQUIV	EQUIVALEN
ERAD	ERADICATION
ERGOD	ERGODIC
ERGOL	ERGOLOGY
EROS	EROSION
EROT	EROTIC
ERUD	ERUDIT
ERUPT	ERUPTION
ERYTHROP	ERYTHROPOIESIS
ESCALAT	ESCALAT
ESCARPM	ESCARPMENT
ESPION	ESPIONAGE
ESSENT	ESSENTIAL
ESTIM	ESTIMATATION
ESTUAR	ESTUARINE
ETCH	ETCHING
ETHIOP	ETHIOPI
ETHN	ETHNI
ETHNOARCHAEOL	ETHNOARCHAEOLOGY
ETHNOASTRON	ETHNOASTRONOM
ETHNOBIOL	ETHNOBIOLOGY
ETHNOBOT	ETHNOBOTAN
ETHNOCULT	ETHNOCULTUR
ETHNOHIST	ETHNOHISTORY
ETHNOPHARMACOL	ETHNOPHARMACOLOGY
ETHOL	ETHOLOGIST
ETHOL	ETHOLOGY
ETHYL	ETHYLENE
EUGEN	EUGENIC
EUKARYOT	EUKARYOTIC
EURACC	EURACCOUNT
EUROANAL	EUROANALYSIS
EUROCURR	EUROCURRENCY
EUROPHYS	EUROPHYSICS
EUROPLAST	EUROPLASTIC
EUROSC	EUROSCOPE
EUROTECH	EUROTECHNISC
EVAC	EVACUEE
EVAL	EVALUATION
EVANST	EVANSTON
EVENT	EVENTOR
EVERGR	EVERGREEN
EVID	EVIDENCE
EVOL	EVOLUTION
EVOL	EVOLVING
EXAM	EXAMINATION
EXAM	EXAMINER
EX	EXAMPLE
EXCAV	EXCAVATION
EXCEED	EXCEED
EXCELL	EXCELL
EXCH	EXCHANGE
EXCIT	EXCIT
EXCLUD	EXCLUDE
EXEC	EXECUTION
EXEG	EXEGESIS
EXEMPT	EXEMPTION
EXERC	EXERCICE
EXHIB	EXHIBITION
EXHUM	EXHUM
EXISTENT	EXISTENTIAL
EXOBIOL	EXOBIOLOGY
EXOG	EXOGENESIS
EXOT	EXOTI
EXPAND	EXPAND
EXPECT	EXPECTED
EXPED	EXPEDITION
EXPEND	EXPENDITURE
EXPENS	EXPENS
EXP	EXPERIEN
EXP	EXPERIMENT
EXPLAIN	EXPLAIN
EXPLAN	EXPLANATION
EXPLOD	EXPLODING
EXPLOR	EXPLORING
EXPLOS	EXPLOSION
EXPON	EXPONENT
EXPORT	EXPORT
EXPO	EXPOSITION
EXPR	EXPRESSION
EXPRESSLETT	EXPRESSLETTER
EXT	EXTENDED
EXT	EXTENDER
EXT	EXTENSION
EXTERM	EXTERMINAT
EXTERN	EXTERNAL
EXTRALICENT	EXTRALICENTIATE
EXTRACELL	EXTRACELLULAR
EXTRACORPOR	EXTRACORPOREAL
EXTR	EXTRACT
EXTRAMUR	EXTRAMUR
EXTRAPULM	EXTRAPULMONAR
EXTRATERR	EXTRATERRESTR
EXTREM	EXTREM
EXTRUD	EXTRUDING
EXTRUS	EXTRUS
FABR	FABRICATION
FACIL	FACILITY
FACSIM	FACSIMILE
FACTB	FACTBOOK
FACTB	FACTBOOK
FACTOR	FACTORING
FACT	FACTORY
FAC	FACULTY
FAIL	FAIL
FAIL	FAILING
FAIL	FAILURE
FAIRFLD	FAIRFIELD
FAIRW	FAIRWAY
FAITHF	FAITHFULLY
FALKL	FALKLAND
FALSIF	FALSIFICATION
FAM	FAMIL
FARMERSV	FARMERSVILLE
FARMINGD	FARMINGDALE
FARML	FARMLAND
FARMST	FARMSTEAD
FARMW	FARMWORK
FARNB	FARNBOROUGH
FASC	FASCICUL
FASH	FASHION
FASTEN	FASTEN
FASTMOV	FASTMOVING
FATAL	FATALITY
FATHER	FATHER
FAT	FATTY
FAVOR	FAVOR
FAYETTEV	FAYETTEVILLE
FEATHER	FEATHERED
FEATUR	FEATURE
FEBR	FEBRUARY
FED	FEDERATION
FEEB	FEEBLE
FEED	FEED
FEEDINGST	FEEDINGSTUFF
FEEL	FEEL
FELLOWSH	FELLOWSHIP
FENC	FENCING
FENL	FENLAND
FERMENT	FERMENTA
FERROCEM	FERROCEMENT
FERROELECTR	FERROELECTRI
FERROMAGN	FERROMAGNETI
FERR	FERROUS
FESTIV	FESTIVAL
FIBROS	FIBROSIS
FIDEL	FIDELITY
FIELDM	FIELDMAN
FIELDSP	FIELDSPORT
FIGHT	FIGHT
FILEB	FILEBOOK
FIL	FILIAL
FILL	FILL
FILMFESTIV	FILMFESTIVAL
FILMMAK	FILMMAK
FILMSTR	FILMSTRIP
FILTER	FILTERING
FILTR	FILTRAT
FINAL	FINAL
FIND	FINDING
FINGERPR	FINGERPRINT
FINISH	FINISH
FINISH	FINISHER
FINISH	FINISHES
FINISH	FINISHING
FINKSBG	FINKSBURG
FINL	FINLAND
FINN	FINNI
FINNL	FINNLAND
FIORDL	FIORDLAND
FIREF	FIREFIGHTER
FIREF	FIREFIGHTING
FIREHOUS	FIREHOUS
FIREPL	FIREPLACE
FIREW	FIREWORKS
FISH	FISHER
FISH	FISHING
FISHKEEP	FISHKEEPING
FIT	FITNESS
FITT	FITTINGLY
FITT	FITTINGS
FIXT	FIXTURE
FLAM	FLAMING
FLAMMABL	FLAMMABILITY
FLAVORDYN	FLAVORDYNAMI
FLAVOR	FLAVORING
FLAVOUR	FLAVOURING
FLEM	FLEMISH
FLEUROPOLYM	FLEUROPOLYMER
FLEX	FLEXIBILITY
FLIP	FLIP
FLOAT	FLOATING
FLOORCOVER	FLOORCOVERING
FLOOR	FLOORING
FLOORSP	FLOORSPACE
FLOR	FLORAL
FLORIC	FLORICULT
FLA	FLORIDA
FLOR	FLORIST
FLORIST	FLORISTIC
FLOR	FLORISTRY
FLOTAT	FLOTATION
FLOWER	FLOWERING
FLOW	FLOWING
FLUEN	FLUENCY
FLUIDDYN	FLUIDDYNAMI
FLUID	FLUIDIZATION
FLUID	FLUIDIC
FLUORAT	FLUORAT
FLUORESC	FLUORESCENT
FLUORID	FLUORIDATION
FLUORIM	FLUORIMETER
FLUOR	FLUORINE
FLY	FLYER
FLYFISH	FLYFISHER
FLY	FLYING
FLYP	FLYPAST
FOAM	FOAM
FOCUS	FOCUS
FODD	FODDER
FOLD	FOLDING
FOLKW	FOLKWEAVE
FOLLOW	FOLLOW
FOODBROK	FOODBROKER
FOODCR	FOODCROP
FOODPROCESS	FOODPROCESSING
FOODSERV	FOODSERVICE
FOODST	FOODSTUFF
FOOTB	FOOTBALL
FOOTB	FOOTBALLER
FOOTPR	FOOTPRINT
FORAMINIFER	FORAMINIFERAL
FORBID	FORBIDDEN
FORECAST	FORECAST
FORECLOS	FORECLOS
FORECLOS	FORECLOSURE
FOREFR	FOREFRONT
FOREH	FOREHEAD
FORERUNN	FORERUNNER
FORESH	FORESHORE
FOR	FOREST
FORG	FORGER
FORG	FORGING
FORGOT	FORGOTTEN
FORMALIZ	FORMALIZATION
FORM	FORMATI
FORM	FORMED
FORMER	FORMERLY
FORM	FORMING
FORMOS	FORMOSAN
FORSHORT	FORSHORT
FT LANGLEY	FORT LANGLEY
FT LAUDERDALE	FORT LAUDERDALE
FT MCCLELL	FORT MCCLELLAN
FT TRYON PARK	FORT TRYON PARK
FT WORTH	FORT WORTH
FORTHCOM	FORTHCOMING
FORTN	FORTNIGHTLY
FORW	FORWARD
FORW	FORWARDER
FOSTER	FOSTER
FOUND	FOUNDATION
FOUND	FOUNDER
FOUND	FOUNDING
FOUNDRYM	FOUNDRYMAN
FRACT	FRACTIONAL
FRACT	FRACTURE
FRAGM	FRAGMENT
FRAGR	FRAGRANCE
FRAM	FRAM
FRAMEW	FRAMEWORK
FRANCH	FRANCHIS
FRANCISC	FRANCISCAN
FRANCOPHIL	FRANCOPHIL
FRANGIP	FRANGIPANI
FRANKF	FRANKFORT
FRANKL	FRANKLIN
FRASER VAL	FRASER VALLEY
FRASERV	FRASERVILLE
FRATERN	FRATERN
FREDERICT	FREDERICTON
FREE	FREE
FREEH	FREEHOLD
FREEL	FREELANC
FREEST	FREESTYLE
FREETH	FREETH
FREET	FREETOWN
FREEWHEEL	FREEWHEELER
FREEZ	FREEZER
FREEZ	FREEZING
FREIGHT	FREIGHTING
FR	FRENCH
FREQ	FREQUEN
FRESHM	FRESHMAN
FRESHW	FRESHWATER
FRICT	FRICTION
FRIENDSH	FRIENDSHIP
FRIES	FRIESIAN
FRIGHT	FRIGHT
FRIGORIF	FRIGORIFIC
FRONT	FRONTIER
FRUITGROW	FRUITGROWER
FRY	FRYER
FRY	FRYING
FULLER	FULLERENE
FULLERT	FULLERTOWN
FUNCT	FUNCTION
FUNDAM	FUNDAMENT
FUND	FUNDATION
FUNDRAIS	FUNDRAISING
FUNER	FUNERA
FUNH	FUNHOUSE
FURBEAR	FURBEAR
FURN	FURNACE
FURNISH	FURNISHER
FURNISH	FURNISHING
FURNIT	FURNITURE
FURTH	FURTHER
FUTUR	FUTURE
GAEL	GAELIC
GAINESV	GAINESVILLE
GALVANIZ	GALVANIZATION
GALVEST	GALVESTON
GAMBL	GAMBLING
GAMEKEEP	GAMEKEEPER
GAMETOG	GAMETOGENES
GARAG	GARAG
GARD	GARDEN
GASDETECT	GASDETECTION
GASDYN	GASDYNAMI
GASFIT	GASFIT
GASIF	GASIFICATION
GASOH	GASOHOL
GASOL	GASOLINE
GASTROENTEROHEPATOL	GASTROENTEROHEPATOL
GASTROINTEST	GASTROINTESTINAL
GASTROKINET	GASTROKINETI
GASTRON	GASTRON
GATESH	GATESHEAD
GATEW	GATEWAY
GATHER	GATHERING
GEND	GENDER
GEN	GENERAL
GENIT	GENITAL
GENITOURIN	GENITOURINARY
GENITOURIN	GENITOURINARY
GENOTOXICOL	GENOTOXICOLOGY
GENTLEM	GENTLEMAN
GEOASTROPHYS	GEOASTROPHYSICS
GEOBIOL	GEOBIOLOGY
GEOCHEM	GEOCHEMISTRY
GEOCHRONOL	GEOCHRONOLOGY
GEOCRYOL	GEOCRYOLOGY
GEOD	GEODAES
GEOD	GEODAET
GEODYN	GEODYNAMI
GEOECOL	GEOECOLOGICAL
GEOELECTR	GEOELECTRIC
GEOENGIN	GEOENGINEERING
GEOEXPLOR	GEOEXPLORATION
GEOGR	GEOGRAPHY
GEOJ	GEOJOURNAL
GEOLINGUIST	GEOLINGUISTICS
GEOMANT	GEOMANTIC
GEOMAT	GEOMATIC
GEOMEMBR	GEOMEMBRANE
GEOMICROBIOL	GEOMICROBIOLOGY
GEOMORPHOL	GEOMORPHOLOGY
GEOPHYS	GEOPHYSICSS
GEOPOLIT	GEOPOLITICS
GEOPRESS	GEOPRESSION
GEORGET	GEORGETOWN
GA	GEORGIA
GEOSP	GEOSPACE
GEOSPH	GEOSPHERE
GEOSTAND	GEOSTANDARD
GEOSYNTH	GEOSYNTHETICS
GEOTECHNOL	GEOTECHNOLOGY
GEOTEXT	GEOTEXTILES
GEOTHERM	GEOTHERMAL
GERALDT	GERALDTON
GER	GERMAN
GER	GERMANY
GESNER	GESNERIA
GESTATION	GESTATIONAL
GET	GETTING
GETTYSBG	GETTYSBURG
GHANA	GHANAIAN
GHOSTBUST	GHOSTBUSTER
GIFT	GIFT
GIPPSL	GIPPSLAND
GIV	GIVING
GLACIAT	GLACIAT
GLACIOL	GLACIOLOGY
GLAM	GLAMORGAN
GLAN	GLANING
GLASG	GLASGOW
GLAZ	GLAZER
GLAZ	GLAZING
GLEAN	GLEANER
GLEAN	GLEANING
GLID	GLID
GLOBUL	GLOBUL
GLORYL	GLORYLAND
GLOSS	GLOSSARY
GLOS	GLOUCESTER
GLOS	GLOUCESTERSHIRE
GLYCOBIOL	GLYCOBIOLOGY
GLYCOCONJ	GLYCOCONJUGATE
GLYCOMED	GLYCOMEDIC
GLYCOSCI	GLYCOSCIENC
GLYCOTECHNOL	GLYCOTECHNOLOGY
GNOZ	GNOZIS
GOATKEEP	GOATKEEPING
GOLD	GOLDEN
GOLDENB	GOLDENBOOK
GOLF	GOLF
GONG	GONGOLA
GOSPEL	GOSPEL
GOV	GOVERNANCE
GOV	GOVERNING
GOV	GOVERNMENT
GOV	GOVERNOR
GRACEF	GRACEFUL
GRAHAMST	GRAHAMSTOWN
GRAINGROW	GRAINGROWER
GRAMM	GRAMMAR
GRAMOPH	GRAMOPHONE
GD FALLS	GRAND FALLS
GD FORKS	GRAND FORKS
GRANT	GRANTING
GRANTMAK	GRANTMAK
GRANT	GRANTOR
GRANTSMANSH	GRANTSMANSHIP
GRANUL	GRANULAR
GRAPEGROW	GRAPEGROWER
GRAPH	GRAPHICS
GRAPHOSC	GRAPHOSCOP
GRAPT	GRAPTOLITE
GRASSHOPP	GRASSHOPP
GRATEFUL	GRATEFUL
GRATUIT	GRATUIT
GRAVELBG	GRAVELBOURG
GRAVIT	GRAVITATION
GRAYL	GRAYLING
GB	GREAT BRITAIN
GT DIVIDE	GREAT DIVIDE
GT LAKES	GREAT LAKES
GT PLAINS	GREAT PLAINS
GT	GREAT
GREENH	GREENHOUSE
GREEN	GREENING
GREENKEEP	GREENKEEPER
GREENKEEP	GREENKEEPING
GREENL	GREENLAND
GREENSB	GREENSBORO
GREET	GREETING
GREGOR	GREGORI
GRENV	GRENVILLE
GRIEV	GRIEVANCE
GRIND	GRINDING
GROC	GROCER
GROUNDF	GROUNDFISH
GROUNDN	GROUNDNUT
GROUNDW	GROUNDWATER
GROUP	GROUPING
GROUPW	GROUPWARE
GROW	GROWER
GROW	GROWING
GUARANT	GUARANTY
GUARD	GUARD
GUARDSM	GUARDSMAN
GUESTH	GUESTHOUSE
GUID	GUID
GUIDEB	GUIDEBOOK
GUIDEL	GUIDELINE
GUILDF	GUILDFORD
GUILDH	GUILDHALL
GUIN	GUINEA
GUJ	GUJARATI
GUN	GUNNER
GYMNAST	GYMNAST
GYNAECOL	GYNAECOLOGY
GYNECOL	GYNECOLOGY
HACKENS	HACKENSACK
HADRON	HADRON
HAEMATOL	HAEMATOLOGY
HAEMATOP	HAEMATOP
HAEMODIAL	HAEMODIALYSIS
HAEMODYN	HAEMODYNAM
HAEMOGENET	HAEMOGENETI
HAEMOPH	HAEMOPHILIA
HAEMORHEOL	HAEMORHEOLOGY
HAEMORRH	HAEMORRHAGIC
HAHNEMANN	HAHNEMANNIAN
HAIRDR	HAIRDRESSER
HALLM	HALLMARKS
HALLUCINOG	HALLUCINOGEN
HAMILT	HAMILTON
HAMPS	HAMPSHIRE
HANDB	HANDBOOK
HANDCR	HANDCRAFT
HANDKNITT	HANDKNITTING
HANDL	HANDLER
HANDL	HANDLING
HANDWRIT	HANDWRIT
HAPPEN	HAPPENING
HARASS	HARASS
HARB	HARBOR
HARDCOVER	HARDCOVER
HARDW	HARDWARE
HARMON	HARMON
HARRISBG	HARRISBURG
HARTLEP	HARTLEPOOL
HARV	HARVARD
HARVEST	HARVEST
HAST	HAST
HATCH	HATCHERY
HATCH	HATCHING
HAUL	HAUL
HAWAII	HAWAIIAN
HAZARD	HAZARDOUS
HEADHUNT	HEADHUNTER
HEAD	HEADING
HEADL	HEADLIN
HEADMAST	HEADMASTERS
HQRS	HEADQUARTERS
HEADW	HEADWAY
HEAL	HEAL
HEALTHC	HEALTHCARE
HEAR	HEAR
HEARTB	HEARTBEAT
HEARTL	HEARTLAND
HEAT	HEATER
HEAT	HEATING
HEAVEN	HEAVEN
HEBR	HEBREW
HEBRID	HEBRIDEAN
HEEDF	HEEDFUL
HEIDELBG	HEIDELBURG
HEIGHT	HEIGHT
HELIPT	HELIPORT
HELMINTHOL	HELMINTHOLOGY
HELP	HELP
HEMATOP	HEMATOP
HEMEROT	HEMEROTECA
HEMICELLUL	HEMICELLULOS
HEMOCHROMATOS	HEMOCHROMATOS
HEMODIAL	HEMODIALYSIS
HEMOFILTR	HEMOFILTRAT
HEMORHEOL	HEMORHEOLOGY
HEMOSTASEOL	HEMOSTASEOLOGY
HEPAT	HEPATITIS
HEPATOCELL	HEPATOCELLULAR
HEPATOTOXIC	HEPATOTOXICITY
HER	HERALD
HERB	HERBAGE
HERB	HERBAL
HERBAL	HERBALISM
HERB	HERBARI
HERBIC	HERBICID
HERED	HEREDI
HEREFORD	HEREFORDSHIRE
HERIT	HERITAGE
HERMENEUT	HERMENEUTICAL
HERMET	HERMETIC
HERON	HERONRY
HERPETOF	HERPETOFAUNA
HERTS	HERTFORDSHIRE
HETEROAROMAT	HETEROAROMATIC
HETEROAT	HETEROATOM
HETEROCYCL	HETEROCYCLIC
HETERONUCL	HETERONUCLEAR
HETEROSTRUCT	HETEROSTRUCTURE
HIDROTECH	HIDROTECHNISCS
HIGH	HIGH
HIGH	HIGHEST
HIGHL	HIGHLAND
HIGHW	HIGHWAY
HIK	HIKING
HILAR	HILAR
HILLINGD	HILLINGDON
HILLSB	HILLSBURGH
HIMAL	HIMALAYAN
HINDU	HINDUISM
HISTOCHEM	HISTOCHEM
HISTOCOMPAT	HISTOCOMPATIBIL
HISTOPATHOL	HISTOPATHOLOGY
HIST	HISTORY
HITCH	HITCH
HOLD	HOLDER
HOLD	HOLDING
HOLIN	HOLINESS
HOLIST	HOLISTICS
HOMEBUY	HOMEBUYING
HOMEL	HOMELAND
HOMEMAK	HOMEMAKER
HOMEOPATH	HOMEOPATH
HOMEOST	HOMEOSTASIS
HOMEOST	HOMEOSTATIC
HOMEOWN	HOMEOWN
HOMESCH	HOMESCHOOL
HOMESTD	HOMESTEAD
HOMEW	HOMEWARE
HOMILET	HOMILET
HOMOAT	HOMOATOMI
HOMOEOPATH	HOMOEOPATH
HOMOG	HOMOGEN
HOMOL	HOMOLOGY
HOMOSEX	HOMOSEX
HONOUR	HONOURABLE
HOOK	HOOKING
HOPEL	HOPELESS
HORIZ	HORIZONTAL
HORMONOG	HORMONOGENES
HORMONOTHER	HORMONOTHERAP
HORTIC	HORTICULT
HOSP	HOSPIT
HOTELK	HOTELKEEPER
HOTELM	HOTELMAN
HOUR	HOUR
HOUSEBOAT	HOUSEBOATING
HOUSEBUILD	HOUSEBUILD
HOUSEH	HOUSEHOLD
HOUSEKEEP	HOUSEKEEP
HOUSEW	HOUSEWARE
HOUS	HOUSING
HOUST	HOUSTON
HOVERCR	HOVERCRAFT
HOVER	HOVERING
HUDDERS	HUDDERSFIELD
HUM	HUMAN
HUM	HUMANE
HUMANIST	HUMANISTIC
HUMANIT	HUMANIT
HUMANIZ	HUMANIZ
HUMBERS	HUMBERSIDE
HUMDING	HUMDINGER
HUNG	HUNGAR
HUNGER	HUNGER
HUNT	HUNTER
HUNT	HUNTING
HUNTINGDONS	HUNTINGDONSHIRE
HUNTINGT	HUNTINGTON
HURRIC	HURRICANE
HUSB	HUSBANDRY
HYBRID	HYBRID
HYBRID	HYBRIDOMA
HYDROCEPH	HYDROCEPHAL
HYDROCHEM	HYDROCHEMISTRY
HYDROCOLL	HYDROCOLLOIDS
HYDROCYCL	HYDROCYCLODES
HYDROELECTR	HYDROELECTRICITY
HYDROGASIF	HYDROGASIFICATION
HYDROG	HYDROGEN
HYDROGEOCHEM	HYDROGEOCHEMISTRY
HYDROLYS	HYDROLYSIS
HYDROMAGN	HYDROMAGNETICS
HYDROMECH	HYDROMECHANICAL
HYDROMETALL	HYDROMETALLURGY
HYDROMETEOROL	HYDROMETEOROLOGY
HYDROM	HYDROMETRY
HYDROPHYS	HYDROPHYSICSS
HYDROSCI	HYDROSCIENCE
HYDROSP	HYDROSPACE
HYDROTECH	HYDROTECHNISCS
HYDROTRANSP	HYDROTRANSPORT
HYG	HYGIEN
HYGROSC	HYGROSCOPIC
HYPERALIMENT	HYPERALIMENT
HYPERFUNCT	HYPERFUNCTION
HYPERLIPID	HYPERLIPIDAEMIA
HYPERNUCL	HYPERNUCLEAR
HYPERREACT	HYPERREACTI
HYPERTENS	HYPERTENSI
HYPERTH	HYPERTHERMIA
HYPNOANAL	HYPNOANAL
HYPN	HYPNOSIS
HYPNOTHER	HYPNOTHERAP
HYPN	HYPNOTI
HYPOTENS	HYPOTENSI
HYSTERECT	HYSTERECTOMY
IATROG	IATROGENIC
IB	IBADAN
IBER	IBERIAN
ICEL	ICELAND
ICONOGR	ICONOGRAPHY
IDA	IDAHO
IDEAL	IDEALISTIC
IDENTIF	IDENTIFICATION
IDEOL	IDEOLOGY
IGALAL	IGALALAND
ILLET	ILLETERACY
ILL	ILLINOIS
ILLN	ILLNESS
ILLUM	ILLUMINATION
ILLUS	ILLUSTRATION
IMAG	IMAGERY
IMMIGR	IMMIGRANT
IMMIGR	IMMIGRATION
IMMOBIL	IMMOBILIZ
IMMUN	IMMUNISATION
IMMUN	IMMUNITY
IMMUN	IMMUNIZATION
IMMUNOALERGOL	IMMUNOALERGOL
IMMUNOANAL	IMMUNOANALY
IMMUNOASS	IMMUNOASSAY
IMMUNOBIOL	IMMUNOBIOLOGY
IMMUNOCHEM	IMMUNOCHEMISTRY
IMMUNOCONJUG	IMMUNOCONJUGATE
IMMUNOCYTOCHEM	IMMUNOCYTOCHEMISTRY
IMMUNODEFIC	IMMUNODEFICIENCY
IMMUNODIAGN	IMMUNODIAGNOS
IMMUNOFLUORESC	IMMUNOFLUORESCEN
IMMUNOGASTROENTEROL	IMMUNOGASTROENTEROLOGY
IMMUNOHEMATOL	IMMUNOHEMATOL
IMMUNOHEMOTHER	IMMUNOHEMOTHERAP
IMMUNOHISTOCHEM	IMMUNOHISTOCHEMISTRY
IMMUNOL	IMMUNOLOGY
IMMUNOMICROBIOL	IMMUNOMICROBIOLOGY
IMMUNOMODIF	IMMUNOMODIF
IMMUNOPATHOL	IMMUNOPATHOLOGY
IMMUNOPEPT	IMMUNOPEPTID
IMMUNOPHARMACOL	IMMUNOPHARMACOLOGY
IMMUNOPROPHYL	IMMUNOPROPHYLAX
IMMUNOREGUL	IMMUNOREGULAT
IMMUNOREHABIL	IMMUNOREHABILIT
IMMUNOREPROD	IMMUNOREPRODUCTI
IMMUNOSTIMUL	IMMUNOSTIMULA
IMMUNOSUPPR	IMMUNOSUPPRESS
IMMUNOSURVEILL	IMMUNOSURVEILLANCE
IMMUNOTHER	IMMUNOTHERAP
IMMUNOTOXICOL	IMMUNOTOXICOLOGY
IMPAIR	IMPAIR
IMPLANT	IMPLANTATION
IMPLEMENT	IMPLEMENTATION
IMPLEMENT	IMPLEMENTING
IMPLIC	IMPLICATION
IMPORT	IMPORTAT
IMPORT	IMPORTED
IMPOS	IMPOSITION
IMPOT	IMPOTENCE
IMPOUND	IMPOUND
IMPR	IMPRESSION
IMPR	IMPRINT
IMPROV	IMPROVEMENT
IMPULS	IMPULSE
INACT	INACTIVE
INAUG	INAUGURAL
INCAPAC	INCAPACITY
INCARCER	INCARCERAT
INCLIN	INCLIN
INCL	INCLUDE
INCL	INCLUSIVE
INCOMPAT	INCOMPATIBILITY
INCRED	INCRED
INCREM	INCREMENTAL
INCUR	INCURRED
INDAG	INDAGATION
INDEBT	INDEBTEDNESS
INDEMNIF	INDEMNIFICATION
INDEP	INDEPENDENT
INDEX	INDEX
INDEX	INDEXED
INDEX	INDEXER
INDEX	INDEXING
INDIANAP	INDIANAPOLIS
INDIC	INDICATION
INDICT	INDICTABLE
INDIG	INDIGEN
INDIVID	INDIVIDUAL
INDOCHEM	INDOCHEMICAL
INDOCH	INDOCHINA
INDOL	INDOLOGICAL
INDUC	INDUCED
INEBR	INEBRIETY
INELAST	INELASTIC
INEQUAL	INEQUALITY
INERT	INERTIAL
INFANT	INFANTIL
INFARCT	INFARCTION
INFECT	INFECTION
INFERENCET	INFERENCET
INFER	INFERIOR
INFERTIL	INFERTILIT
INFEST	INFESTATION
INFIRM	INFIRM
INFLAMM	INFLAMMATION
INFLAMM	INFLAMMATORY
INFLAT	INFLATION
INFLU	INFLUENCE
INFOLETT	INFOLETTER
INF	INFORMATION
INF	INFORMANT
INFORM	INFORMATICS
INF	INFORMATIV
INF	INFORMATOR
INFORMETR	INFORMETRIC
INFOSCI	INFOSCIENCE
INFOTAIN	INFOTAINMENT
INFRAMICROBIOL	INFRAMICROBIOLOGY
INGEN	INGENUITY
INGLEW	INGLEWOOD
INGRED	INGREDIENT
INHAL	INHALA
INHERIT	INHERITANCE
INHERIT	INHERITED
INJECT	INJECTION
INJ	INJURY
INKMAK	INKMAK
INLAND	INLANDER
INLIGHT	INLIGHT
INN	INNER
INNKEEP	INNKEEP
INORG	INORGANIC
INOSIT	INOSITIDES
INQ	INQUEST
INQ	INQUIRY
INRICHT	INRICHTING
INSECTIC	INSECTICIDE
INSECTOFUNGIC	INSECTOFUNGICID
INSEMIN	INSEMINATION
INSERV	INSERVICE
INSID	INSID
INSIGN	INSIGNIA
INSOLV	INSOLVENCY
INSP	INSPECTION
INSPIR	INSPIRATOR
INSTAB	INSTABILITY
INSTALM	INSTALMENT
INSTANT	INSTANTANE
INST	INSTITUTE
INSTR	INSTRUCT
INSTRUM	INSTRUMENT
INSTRUM	INSTRUMENTAL
INSTRUM	INSTRUMENTATION
INSUR	INSUR
INSURG	INSURGENT
INSURRECT	INSURRECTIONARY
INTEGR	INTEGRATED
INTEGR	INTEGRATIVE
INTEGR	INTEGRATOR
INTEGR	INTEGRITY
INTL	INTERNATIONAL
INTELLECT	INTELLECTUAL
INTELL	INTELLIGENCE
INTEND	INTENDED
INTEND	INTENDENT
INTEND	INTENDING
INTENSIF	INTENSIFICATION
INTENT	INTENTION
INTERACT	INTERACTING
INTERACT	INTERACTION
INTERACT	INTERACTIVE
INTERAFR	INTERAFRICA
INTERAG	INTERAGENCY
INTERAT	INTERATOMIC
INTERCELL	INTERCELLULAR
INTERCEPT	INTERCEPTION
INTERCESS	INTERCESSION
INTERCHEM	INTERCHEMICAL
INTERCOLL	INTERCOLLEGIATE
INTERCOMP	INTERCOMPARISON
INTERCONNECT	INTERCONNECTION
INTERCONVERS	INTERCONVERSION
INTERCRYST	INTERCRYSTALL
INTERCULT	INTERCULTUR
INTERDENOMINATL	INTERDENOMINATIONAL
INTERDEP	INTERDEPARTMENT
INTERDEPEND	INTERDEPENDENC
INTERDIFFUS	INTERDIFFUSION
INTERDISCIP	INTERDISCIPLINE
INTEREST	INTERESTED
INTERF	INTERFERENCE
INTERFEROM	INTERFEROMETER
INTERGOV	INTERGOVERNEMENT
INTERGOV	INTERGOVERNMENT
INTERLAB	INTERLABORATORY
INTERLANG	INTERLANGUAGE
INTERLEND	INTERLENDING
INTERMED	INTERMEDIATE
INTERMET	INTERMETALLI
INTERMT	INTERMOUNTAIN
INTERN	INTERNAL
INT	INTERNATION
INTERNSH	INTERNSHIP
INTERPARLEM	INTERPARLEMENT
INTERPENETR	INTERPENETRAT
INTERPERS	INTERPERSONAL
INTERPHOTORECEPT	INTERPHOTORECEPT
INTERPLANET	INTERPLANETARY
INTERPLAST	INTERPLASTIC
INTERPOLAT	INTERPOLATION
INTERPROV	INTERPROVINC
INTERREG	INTERREGION
INTERRELAT	INTERRELATION
INTERRELIG	INTERRELIGIOUS
INTERSCI	INTERSCIENCE
INTERSERV	INTERSERVICE
INTERSOC	INTERSOCIETY
INTERSTUD	INTERSTUD
INTERSYND	INTERSYNDICAL
INTERUNIV	INTERUNIVERSIT
INTIM	INTIMACY
INTIM	INTIMAT
INTIM	INTIMATE
INTOLER	INTOLERANT
INTOX	INTOXICAT
INTRACELL	INTRACELLULAR
INTRACONT	INTRACONTINENT
INTRAMOL	INTRAMOLECULARLECULARAR
INTRAUTER	INTRAUTERINE
INTRAVASC	INTRAVASCUL
INTRAVEN	INTRAVEN
INTROD	INTRODUCTION
INTROSP	INTROSPECTION
INVENT	INVENTING
INVENT	INVENTION
INVENT	INVENTOR
INVERTEBR	INVERTEBRAT
INVERT	INVERTED
INVERT	INVERTER
INVEST	INVESTING
INVEST	INVESTMENT
INVEST	INVESTOR
INVIS	INVISIBLE
INVIT	INVIT
INVOLV	INVOLV
INVOLV	INVOLVEMENT
IONIZ	IONIZ
IONOS	IONOSPHER
IREL	IRELAND
IR	IRISH
IRL	IRLAND
IRONMAK	IRONMAKING
IRONWORK	IRONWORKER
IROQ	IROQUOIAN
IRRADIAT	IRRADIATED
IRRADIAT	IRRADIATION
IRREGUL	IRREGULAR
ISCHAEM	ISCHAEMIA
ISCHAEM	ISCHAEMIC
ISOCHRON	ISOCHRONOUS
ISOELECTRON	ISOELECTRONICS
ISOKINET	ISOKINETICS
ISOL	ISOLATION
ISSU	ISSUING
JACKSONV	JACKSONVILLE
JAM	JAMAICA
JPN	JAPAN
JAZZOL	JAZZOLOGY
JENKINT	JENKINTOWN
JERUS	JERUSALEM
JET	JETTING
JEWEL	JEWEL
JEW	JEWISH
JEW	JEWRY
JOBCENT	JOBCENTRE
JOBHOLD	JOBHOLDING
JOBSEEK	JOBSEEKER
JOG	JOGGER
JOG	JOGGING
JOHANNESBG	JOHANNESBURG
JOHNS	JOHNSON
JOIN	JOINERY
JOIN	JOINING
JT	JOINT
JT	JOINTING
J	JOURNAL
JOTT	JOTTING
JOYF	JOYFUL
JUBIL	JUBILEE
JUD	JUDAIC
JUD	JUDAISM
JUDG	JUDGING
JUDGM	JUDGMENT
JUDIC	JUDICATURE
JUDIC	JUDICIA
JUGENDR	JUGENDRECHT
JUGGL	JUGGL
JUMP	JUMP
JR	JUNIOR
JURASS	JURASSIC
JURIMETR	JURIMETRIC
JURISD	JURISDICTION
JUSTIF	JUSTIFICATION
JUV	JUVENIL
KAD	KADUNA
KANS	KANSAS
KAYAK	KAYAK
KAYAK	KAYAKER
KAYAK	KAYAKING
KEEP	KEEPER
KEEP	KEEPING
KELVINGT	KELVINGTON
KEMPTV	KEMPTVILLE
KY	KENTUCKY
KENTV	KENTVILLE
KERATOREFRACT	KERATOREFRACTIVE
KEYNES	KEYNESIAN
KEYST	KEYSTONE
KHEDIV	KHEDIVIAL
KILL	KILL
KIMBERL	KIMBERLITE
KINEMAT	KINEMATICS
KINESIOL	KINESIOL
KINESIOL	KINESIOLOGY
KINGD	KINGDOM
KINGST	KINGSTO(W)N
KINGSV	KINGSVILLE
KINSH	KINSHIP
KINSM	KINSMAN
KIRCHENMUSIK	KIRCHENMUSIKALISCH
KIRKL	KIRKLAND
KIRKSV	KIRKSVILLE
KIRKW	KIRKWOOD
KNITT	KNITT
KNITW	KNITWEAR
KNOWL	KNOWLEDGE
KNOWLT	KNOWLTON
KNOXV	KNOXVILLE
KOREANOL	KOREANOLOGY
KRON	KRONICLE
KURD	KURDISH
LABANOT	LABANOTATION
LABEL	LABELLED
LABEL	LABELLING
LACAN	LACANIAN
LACEMAK	LACEMAKER
LACQ	LACQUER
LACTOG	LACTOGENIC
LACTOL	LACTOLOGY
LAKEL	LAKELAND
LAKET	LAKETOWN
LAMBT	LAMBTON
LANCS	LANCASHIRE
LANC	LANCASTER
LANDESVER	LANDESVEREIN
LANDF	LANDFORM
LAND	LANDING
LANDOWN	LANDOWNING
LANDRAC	LANDRAC
LANDSC	LANDSCAPE
LANDW	LANDWARD
LANG	LANGUAGE
LANTHAN	LANTHANIDE
LAPAROENDOSC	LAPAROENDOSCOP
LAPAROSC	LAPAROSCOPIC
LAPAROSC	LAPAROSCOPY
LAPID	LAPIDARY
LARAM	LARAMIE
LARCHMT	LARCHMONT
LARG	LARGER
LARG	LARGEST
LARVIC	LARVICULTURE
LAT	LATIN
LATV	LATV
LAUGH	LAUGH
LAUND	LAUND
LAURENT	LAURENTIAN
LAYER	LAYERED
LAY	LAYING
LEAD	LEADER
LEADERSH	LEADERSHIP
LEAD	LEADING
LEAFL	LEAFLET
LEAG	LEAGUE
LEAK	LEAKING
LEARN	LEARN
LEASEH	LEASEHOLD
LEAS	LEASING
LEAV	LEAVER
LEBAN	LEBANESE
LEBAN	LEBANON
LECTION	LECTIONARY
LECT	LECTURE
LECTURESH	LECTURESHIP
LEG	LEGACY
LEG	LEGAL
LEGEND	LEGEND
LEGION	LEGION
LEIC	LEICESTER
LEICS	LEICESTERSHIRE
LEIS	LEISUR
LEISUREW	LEISUREWEAR
LEND	LENDING
LENNOXV	LENNOXVILLE
LEPR	LEPROSY
LESLIEV	LESLIEVILLE
LETT	LETTER
LEUKAEMOG	LEUKAEMOGENES
LEUKEMOGENES	LEUKEMOGENESIS
LEUKOC	LEUKOCYTE
LEUKOT	LEUKOTRI
LEXICOGR	LEXICOGRAPHY
LEXINGT	LEXINGTON
LIABIL	LIABILITY
LIB	LIBERAL
LIB	LIBERATOR
LIBERT	LIBERTARIAN
LIB	LIBERTY
LIBR	LIBRAR
LIBRARIANSH	LIBRARIANSHIP
LIBRETT	LIBRETTIST
LICENC	LICENCED
LICENS	LICENSE
LICENT	LICENTIATE
LICHF	LICHFIELD
LIEUTEN	LIEUTENANT
LIFESAV	LIFESAVING
LIFESK	LIFESKILL
LIFESP	LIFESPAN
LIFT	LIFTING
LIGHT	LIGHT
LIGNIT	LIGNITIC
LIGNOCELLUL	LIGNOCELLULOS
LIMEST	LIMESTONE
LIMIT	LIMITATION
LTD	LIMITED
LINC	LINCOLN
LINCS	LINCOLNSHIRE
LINK	LINKAGE
LINK	LINKER
LINK	LINKING
LINKLETT	LINKLETTER
LINN	LINNEAN
LIPIDOL	LIPIDOLOGY
LIPP	LIPPED
LIQ	LIQUEF
LIQ	LIQUID
LIQUOR	LIQUOR
LIST	LISTOK
LIT	LITERACY
LIT	LITERAR
LITHOPR	LITHOPRINTER
LITHOSTRATIGR	LITHOSTRATIGRAPHY
LITHOTR	LITHOTRIPSY
LITIG	LITIGATION
LITIG	LITIGATOR
LITURG	LITURG
LIVEST	LIVESTOCK
LIVERP	LIVERPOOL
LIVEST	LIVESTOCK
LOAD	LOADING
LOBBY	LOBBYIST
LOCAL	LOCALLY
LOCAT	LOCATION
LOCKSMITH	LOCKSMITH
LODG	LODG
LOGB	LOGBOOK
LOG	LOGIC
LOG	LOGICAL
LOGIST	LOGISTIC
LOGOP	LOGOPAEDI
LOGOTHER	LOGOTHERAP
LOND	LONDON
LONG	LONGEST
LONGEV	LONGEVITY
LONGITUD	LONGITUDINAL
LOOK	LOOKING
LOS ANGEL	LOS ANGELES
LOUGHB	LOUGHBOROUGH
LA	LOUISIANA
LOW	LOW
LOWGR	LOWGROUND
LOWL	LOWLAND
LOYAL	LOYAL
LUBR	LUBRICANT
LUBR	LUBRICAT
LUGG	LUGGAGE
LUMBERM	LUMBERMAN
LUMBERY	LUMBERYARD
LUMIN	LUMINESCENCE
LUMIN	LUMINOUS
LUS	LUSATIAN
LUTHER	LUTHERANER
LUX	LUXUR
LYNNW	LYNNWOOD
LYR	LYRIC
MACH	MACHINE
MACROCYCL	MACROCYCLIC
MACROECON	MACROECONOM
MACROMOL	MACROMOLECULAR
MACRONUTR	MACRONUTRIENT
MACROPRUDENT	MACROPRUDENT
MACROSC	MACROSCOPIC
MAG	MAGAZIN
MAGIC	MAGICAL
MAGNETOELECTRON	MAGNETOELECTRONICS
MAGNETORHEOL	MAGNETORHEOLOGY
MAGNETOS	MAGNETOSPHER
MAGNIFY	MAGNIFY
MAHOG	MAHOGANY
MAID	MAIDUGURI
MAIL	MAIL
MAILB	MAILBOX
MAINL	MAINLAND
MAINT	MAINTAIN
MAINTAINAB	MAINTAINABILITY
MAJOR	MAJORITY
MAK	MAKER
MAK	MAKING
MALACOL	MALACOLOGY
MALADJUST	MALADJUSTED
MALAR	MALARIA
MALAY	MALAYAN
MALAYS	MALAYSIA
MALES	MALESIAN
MALFORM	MALFORMATION
MALFUNCT	MALFUNCTION
MALIG	MALIGNAN
MALPRACT	MALPRACTICE
MALT	MALTESE
MALT	MALTING
MAMILL	MAMILLARIA
MAMMAL	MAMMALOGY
MAMM	MAMMALS
MAMMOGR	MAMMOGRAPHY
MANCH	MANCHESTER
MANDAT	MANDATORY
MANDOL	MANDOLIN
MANGL	MANGL
MANICH	MANICHEAN
MANIF	MANIFESTO
MANIL	MANILANA
MANIP	MANIPUL
MANIT	MANITOBA
MANK	MANKIND
MANOR	MANORIAL
MANPOW	MANPOWER
MAN	MANUAL
MANUF	MANUFACTURE
MANUF	MANUFACTOR
MANUSCR	MANUSCRIPT
MAPP	MAPPING
MARIC	MARICULT
MAR	MARINE
MARITAL	MARITAL
MARIT	MARITIME
MARK	MARKET
MARKETB	MARKETBOOK
MARKETLETT	MARKETLETTER
MARKETM	MARKETMAN
MARKETPL	MARKETPLACE
MARLBGH	MARLBOROUGH
MARRICKV	MARRICKVILLE
MARSHALLT	MARSHALLTOWN
MARYBGH	MARYBOROUGH
MD	MARYLAND
MASON	MASONRY
MASS	MASSACHUSETTS
MASTERCL	MASTERCLASS
MATCHB	MATCHBOX
MATER	MATERIALS
MATER	MATERIEL
MATH	MATHEMAT
MATHW	MATHWARE
MATUR	MATURE
MAURIT	MAURITIUS
MAUSOL	MAUSOLEUM
MAXILLOFAC	MAXILLOFACIAL
MAXILLOFAC	MAXILLOFACIAL
MEAND	MEANDER
MEAN	MEANING
MEAS	MEASURE
MECH	MECHANI
MECHANOBIOL	MECHANOBIOLOGY
MECHAOPTOELECTRON	MECHAOPTOELECTRON
MECHATRON	MECHATRONIC
MED	MEDECINE
MEDIAT	MEDIAT
MED	MEDICAL
MEDICAT	MEDICAT
MEDIEV	MEDIEV
MEDIOTECH	MEDIOTECHNISCA
MEDITERR	MEDITERRANE
MEDLIN	MEDLIN
MEET	MEETING
MELD	MELDING
MELIOR	MELIORATION
MEMB	MEMBER
MEMBSH	MEMBERSHIP
MEMBR	MEMBRAN
MEM	MEMENTO
MEMET	MEMETICS
MEM	MEMOIR
MEMORAB	MEMORAB
MEMO	MEMORAND
MEML	MEMORIAL
MEM	MEMORY
MENNON	MENNONIT
MENS	MENSUAL
MENSW	MENSWEAR
MENT	MENTAL
MENTOR	MENTORING
MERC	MERCANTIL
MERCH	MERCHANDISE
MERCH	MERCHANT
MERSEYS	MERSEYSIDE
MESOAM	MESOAMERICA
MESOMECH	MESOMECHANI
MESOP	MESOPOTAMIA
MESOS	MESOSPHER
MESOZ	MESOZOIC
MESSEMAG	MESSEMAGAZINE
METAB	METABOLE
METALLOCERAM	METALLOCERAM
METALLOGR	METALLOGRAPHY
METALLORG	METALLORGANIC
METALWORK	METALWORKER
METALWORK	METALWORKING
METAMORPH	METAMORPH
METAPHOR	METAPHOR
METAPHYS	METAPHYSICSS
METEOR	METEORITE
METEORIT	METEORITIC
METHAD	METHADONE
METHODOL	METHODOLOGY
METR	METRIC
METROECON	METROECONOMY
MICH	MICHIGAN
MICROANAL	MICROANALYS
MICROANAL	MICROANALYT
MICROANAT	MICROANATOM
MICROAUTORADIOGR	MICROAUTORADIOGRAPHY
MICROB	MICROBIAL
MICROBIOL	MICROBIOLOGY
MICROCALORIM	MICROCALORIMETER
MICROCARDIOGR	MICROCARDIOGRAPHY
MICROCHEM	MICROCHEM
MICROCIRC	MICROCIRCULAT
MICROCLIM	MICROCLIMAT
MICROCOMPON	MICROCOMPONENT
MICROCOMPUT	MICROCOMPUT
MICROCRYST	MICROCRYSTAL
MICRODENSITOM	MICRODENSITOMETER
MICRODOSIM	MICRODOSIMETER
MICROECON	MICROECONOMIC
MICROELECTRON	MICROELECTRONICS
MICROENCAPSUL	MICROENCAPSULATION
MICROENVIRON	MICROENVIRONMENT
MICROFABR	MICROFABRICATION
MICROFLUID	MICROFLUID
MICROGR	MICROGRAPHY
MICROHETEROG	MICROHETEROGEN
MICROINSTRUM	MICROINSTRUMENTATION
MICROINVERTEBR	MICROINVERTEBRATE
MICROLITHOGR	MICROLITHOGRAPHY
MICROMACH	MICROMACHINING
MICROMINIAT	MICROMINIATURIZATION
MICROMORPHOL	MICROMORPHOLOGY
MICRONES	MICRONESIA
MICRONEUROSURG	MICRONEUROSURG
MICRONUTR	MICRONUTRIENT
MICROORG	MICROORGANISM
MICROPALEONTOL	MICROPALEONTOLOGY
MICROPHOTOM	MICROPHOTOMETER
MICROPHYS	MICROPHYSICS
MICROPROCESS	MICROPROCESS
MICROPROF	MICROPROFESSIONAL
MICROPROGR	MICROPROGRAMM
MICROPROPAG	MICROPROPAGATION
MICROPROPULS	MICROPROPULS
MICROPUBL	MICROPUBLISH
MICRORADIOGR	MICRORADIOGRAPHY
MICROREACT	MICROREACTION
MICROSC	MICROSCOPE
MICROSENS	MICROSENSOR
MICROSOC	MICROSOCIAL
MICROSPECTROSC	MICROSPECTROSCOP
MICROSTRUCT	MICROSTRUCTURE
MICROSURG	MICROSURG
MICROSYMP	MICROSYMPOSIUM
MICROSYST	MICROSYSTEM
MICROTECH	MICROTECHNICS
MICROVASC	MICROVASCUL
MICROWAV	MICROWAVABLE
MICROW	MICROWAVE
MICROZONAT	MICROZONATION
MIDATL	MIDATLANTIC
MIDCENT	MIDCENTRAL
MIDCONT	MIDCONTINENT
MIDDLESB	MIDDLESBROUGH
MIDDX	MIDDLESEX
MIDDLET	MIDDLETON
MIDDLET	MIDDLETOWN
MIDDLEW	MIDDLEWARE
MIDEAST	MIDEAST
MIDG	MIDGET
MIDL	MIDLAND
MIDNORTH	MIDNORTH
MIDWEST	MIDWESTERN
MIGHT	MIGHTIER
MIGR	MIGRANT
MIGR	MIGRATION
MIGR	MIGRATORY
MILEST	MILESTONE
MILIT	MILITANT
MIL	MILITAR
MILK	MILKING
MILLENN	MILLENNI
MILL	MILLER
MILLIM	MILLIMETER
MILLION	MILLIONAIRE
MILLT	MILLTOWN
MINC	MINCED
MIN	MINER
MINEROL	MINEROLOGY
MINEWORK	MINEWORKER
MINIAT	MINIATURIST
MINICOMPUT	MINICOMPUTER
MINICONF	MINICONFERENCE
MINIM	MINIMALLY
MINIM	MINIMUM
MIN	MINING
MINIST	MINISTER
MINISYMP	MINISYMPOS
MINNEAP	MINNEAPOLIS
MINN	MINNESOTA
MISCARR	MISCARRIAGE
MISC	MISCELLAN
MISDEMEAN	MISDEMEANANT
MISSIOL	MISSIOLOGICAL
MISS	MISSISSIPPI
MO	MISSOURI
MITCHELLV	MITCHELLVILLE
MITIG	MITIGATION
MIX	MIX
MNEMON	MNEMONIC
MOB	MOBILE
MOBIL	MOBILITY
MODEL	MODEL
MODEL	MODELISATION
MODEL	MODELL
MOD	MODERN
MODUL	MODULARITY
MOLD	MOLDAV
MOL	MOLECULAR
MOLINOL	MOLINOLOGY
MOLLUSCIC	MOLLUSCICIDE
MOLYBD	MOLYBDENIUM
MONAGRIC	MONAGRICULTURAL
MONCT	MONCTON
MOND	MONDIAL
MONEYLEND	MONEYLENDER
MONEYMAK	MONEYMAK
MONG	MONGOLIA
MONIT	MONITOR
MONKEYSH	MONKEYSHINE
MONMOUTHS	MONMOUTHSHIRE
MONOCLON	MONOCLONAL
MONOENERG	MONOENERGETIC
MONOGR	MONOGRAPHY
MONOMOL	MONOMOLECULAR
MONONUCL	MONONUCLEAR
MONOSACCH	MONOSACCHARIDE
MONT	MONTANA
MON	MONTH
MONTPEL	MONTPELIER
MONTR	MONTREAL
MONTSERRAT	MONTSERRAT
MONUM	MONUMENT
MOORL	MOORLAND
MORAL	MORALITY
MORAT	MORATORIUM
MORGANT	MORGANTOWN
MOROC	MOROCC
MORPHOG	MORPHOGEN
MORPHOL	MORPHOLOGY
MORRINSV	MORRINSVILLE
MORTAL	MORTALITY
MORTG	MORTGAGE
MORTU	MORTU
MOSC	MOSCOW
MOTHER	MOTHERHOOD
MOTIL	MOTILITY
MOTOCR	MOTOCROSS
MOT	MOTOR
MOTORBOAT	MOTORBOAT
MOTORCYCL	MOTORCYCLIST
MOTORH	MOTORHOME
MOTORMAK	MOTORMAK
MOTORW	MOTORWAY
MOT	MOTRIC
MOULD	MOULD
MT	MOUNT
MT	MOUNTAIN
MOV	MOVEMENT
MOV	MOVER
MOV	MOVING
MOZAMB	MOZAMBICAN
MUCOPOLYSACCH	MUCOPOLYSACCHARIDE
MUFF	MUFFL
MULTICELL	MULTICELLULAR
MULTICENT	MULTICENTER
MULTICHEM	MULTICHEMISTRY
MULTICRIT	MULTICRITICAL
MULTIDENT	MULTIDENTA
MULTIDISCIP	MULTIDISCIPLINE
MULTIELEM	MULTIELEMENT
MULTIFUNCT	MULTIFUNCTION
MULTIHANDICAP	MULTIHANDICAP
MULTIHORM	MULTIHORMON
MULTILAB	MULTILABORATORY
MULTILATER	MULTILATERAL
MULTILING	MULTILINGUAL
MULTILING	MULTILINGUALISM
MULTIMET	MULTIMETALLIC
MULTINATL	MULTINATIONAL
MULTINUCL	MULTINUCLEAR
MULTIPH	MULTIPHASE
MULTIPROF	MULTIPROFESSIONAL
MULTIPURP	MULTIPURPOSE
MULTISENS	MULTISENSOR
MULTITARG	MULTITARGET
MULTITASK	MULTITASKING
MULTIVAR	MULTIVARIATE
MUNIC	MUNICIP
MURD	MURDER
MUSCULOSKELET	MUSCULOSKELETAL
MUS	MUSEUM
MUSIC	MUSIC
MUSTEL	MUSTELID
MUTAGEN	MUTAGEN
MUTAT	MUTATION
MUTUAL	MUTUALIZATION
MYCEN	MYCENAEAN
MYCOBACT	MYCOBACTERIA
MYCOBACT	MYCOBACTERIAL
MYCOL	MYCOLOGY
MYCOPATHOL	MYCOPATHOLOGY
MYCOPLASM	MYCOPLASMAL
MYCOPLASMOL	MYCOPLASMOLOGY
MYOCARD	MYOCARDIAL
MYOCARDIOL	MYOCARDIOLOGY
MYOCHEM	MYOCHEMISTRY
MYRIAP	MYRIAPOD
MYXOBACT	MYXOBACTERIA
NAMEPL	NAMEPLATE
NAMIB	NAMIBI
NANOELECTRON	NANOELECTRONICS
NANOENG	NANOENGINEERING
NANOMATER	NANOMATER
NANOSCI	NANOSCIENCE
NANOSYST	NANOSYSTEM
NANOTECHNOL	NANOTECHNOLOGY
NANOTUB	NANOTUB
NARC	NARCOTIC
NARRAT	NARRAT
NASHV	NASHVILLE
NATAL	NATALITY
NATL	NATIONAL
NATLY	NATIONALITY
NATIV	NATIV
NATRIURET	NATRIURETIC
NAT	NATURAL
NAT	NATURE
NATUREGR	NATUREGRAPHY
NATUREOPATH	NATUREOPATH
NATUR	NATURIST
NAUT	NAUTIC
NAV	NAVAL
NEAREAST	NEAREAST
NEB	NEBRASKA
NEBUL	NEBUL
NECESSAR	NECESSARILY
NEGAT	NEGATIVE
NEGL	NEGLECT
NEGLIGENCE	NEGLIGENCE
NEGOC	NEGOCIATE
NEGOT	NEGOTIATION
NEIGHB	NEIGHBOUR
NEMATIC	NEMATICIDE
NEONATOL	NEONATOLOGY
NEOPLAST	NEOPLASTIC
NEPAL	NEPALESE
NEPHOL	NEPHOLOGY
NEPHROL	NEPHROLOGY
NEPHROPATHOL	NEPHROPATHOLOGY
NEPHROP	NEPHROPATHY
NEPHROTOX	NEPHROTOXICIT
NEPHROUROL	NEPHROUROLOGY
NERV	NERVOUS
NETH	NETHERLANDS
NETW	NETWORK
NETW	NETWORKING
NEUROACT	NEUROACTIV
NEUROANAESTH	NEUROANAESTHES
NEUROBEHAV	NEUROBEHAVIOR
NEUROCHEM	NEUROCHEM
NEUROCHIR	NEUROCHIRURG
NEUROCYTOCHEM	NEUROCYTOCHEMISTRY
NEUROCYTOL	NEUROCYTOLOGY
NEURODEGENER	NEURODEGENERATI
NEURODEV	NEURODEVELOP
NEUROENDOCRINOL	NEUROENDOCRINOLOGY
NEUROETHOL	NEUROETHOLOGY
NEUROGASTROENTEROL	NEUROGASTROENTEROLOGY
NEUROGENET	NEUROGENETIC
NEUROIMMUNOENDOCRINOL	NEUROIMMUNOENDOCRINOLOGY
NEUROIMMUNOL	NEUROIMMUNOLOGY
NEUROMORPHOL	NEUROMORPHOLOGY
NEUROMUSCUL	NEUROMUSCULAR
NEUROMUSCULOSKEL	NEUROMUSCULOSKELETAL
NEURONUCL	NEURONUCLEAR
NEUROOPHTHALMOL	NEUROOPHTHALMOLOGY
NEUROPEPT	NEUROPEPTIDE
NEUROPHARMACOL	NEUROPHARMACOLOGY
NEUROPLAST	NEUROPLASTIC
NEUROPSYCHOPHARMACOL	NEUROPSYCHOPHARMACOLOGY
NEUROPSYCHOTHER	NEUROPSYCHOTHERAP
NEUROPTEROL	NEUROPTEROLOGY
NEURORADIOL	NEURORADIOLOGY
NEURORECEPT	NEURORECEPTOR
NEUROREGUL	NEUROREGULAT
NEUROSCI	NEUROSCIENCE
NEUROSURG	NEUROSURGERY
NEUROSURG	NEUROSURGIC
NEUROTERATOL	NEUROTERATOLOGY
NEUROTHER	NEUROTHERAP
NEUROTOL	NEUROTOLOGY
NEUROTOX	NEUROTOXICITY
NEUROTRAUMATOL	NEUROTRAUMATOLOGY
NEUROTROP	NEUROTROPIC
NEUROUROL	NEUROUROLOGY
NEUROVISC	NEUROVISCERAL
NEV	NEVADA
NB	NEW BRUNSWICK
N	NORTH
NE	NORTHEAST
NW	NORTHWEST
N ENGL	NEW ENGLAND
N GUIN	NEW GUINEA
NH	NEW HAMPSHIRE
N HAV	NEW HAVEN
N HEBR	NEW HEBRIDES
NJ	NEW JERSEY
NM	NEW MEXICO
NSW	NEW SOUTH WALES
NY	NEW YORK
NZ	NEW ZEALAND
NZ	NEWZELANDESA
NEWCTLE	NEWCASTLE
NEWCOM	NEWCOM
NFLD	NEWFOUNDLAND
NEW	NEWLY
NEWMARK	NEWMARKET
NEWSSH	NEWSSHEET
NEWSAG	NEWSAGENT
NEWSBR	NEWSBRIEF
NEWSCLIPP	NEWSCLIPPING
NEWSERV	NEWSERVICE
NEWSF	NEWSFILE
NEWSH	NEWSHEET
NEWSJ	NEWSJOURNAL
NEWSL	NEWSLETTER
NEWSMAG	NEWSMAG
NEWSMAK	NEWSMAK
NEWSP	NEWSPAPER
NEWSPR	NEWSPRINT
NEWSREP	NEWSREPORT
NEWSREV	NEWSREVIEW
NEWSSH	NEWSSHEET
NEWSTR	NEWSTREND
NEWTON	NEWTONIAN
NIAGARA F	NIAGARA FALLS
NICOS	NICOSIA
NIGER	NIGERIA
NINET	NINETEEN
NITROCELLUL	NITROCELLULOS
NOMENCL	NOMENCLATURE
NOMIN	NOMINEE
NONGOV	NONGOVERNEMENT
NONLEAG	NONLEAGUE
NONOFF	NONOFFICIAL
NONPERISH	NONPERISHABLE
NONPROLIF	NONPROLIFERATION
NONRESID	NONRESIDENTIAL
NONBACT	NONBACTERIAL
NONCONSERV	NONCONSERVATIVE
NONCONV	NONCONVENTIONAL
NONCRYST	NONCRYSTAL
NONCULT	NONCULTURE
NONDESTRUCT	NONDESTRUCTION
NONDRAM	NONDRAMATIC
NONFERMENT	NONFERMENTALI
NONFICT	NONFICTION
NONFORM	NONFORMAL
NONHUM	NONHUMAN
NONION	NONIONIC
NONISOT	NONISOTOPI
NONLITHOGR	NONLITHOGRAPHY
NONMET	NONMETALLIC
NONPSYCHIATR	NONPSYCHIATRI
NONRESON	NONRESONANT
NONRESPIR	NONRESPIRAT
NONSMOK	NONSMOK
NONSTOICHIOM	NONSTOICHIOMETER
NONTRADIT	NONTRADITION
NORSEM	NORSEMAN
N AM	NORTH AMERICA
N ATL	NORTH ATLANTIC
N BRUNSW	NORTH BRUNSWICK
NC	NORTH CAROLINA
ND	NORTH DAKOTA
N MELB	NORTH MELBOURNE
N QLD	NORTH QUEENSLAND
N HOLL	NORTHHOLLAND
NORTHAMP	NORTHAMPTON
NORTHANTS	NORTHAMPTONSHIRE
NORTHEAST	NORTHEAST
NORTH	NORTHERN
NORTHL	NORTHLAND
NORTHUMBERL	NORTHUMBERLAND
NORTHUMBR	NORTHUMBRIA
N WT	NORTHWEST TERRITORIES
NORTHWEST	NORTHWESTERN
NORT	NORTON
NOR	NORWAY
NOR	NORWEGIAN
NOSOCOM	NOSOCOMIAL
NOTAR	NOTARIA
NOTEB	NOTEBOOK
NOTIF	NOTIFIABLE
NOTIF	NOTIFICA
NOTIF	NOTIFIED
NOTTM	NOTTINGHAM
NOTTS	NOTTINGHAMSHIRE
NOV	NOVEL
INTERPOLAT	NTERPOLATION
NUCL	NUCLEAR
NUCL	NUCLEIC
NUCLEON	NUCLEONIC
NUCL	NUCLEUS
NUIS	NUISANCE
NUMER	NUMERIC
NUMISLETT	NUMISLETTER
NURS	NURSERY
NURSERYM	NURSERYMAN
NURS	NURSING
NURTUR	NURTUR
NUTGROW	NUTGROWER
NUTMEGG	NUTMEGGER
NYASAL	NYASALAND
OAKL	OAKLAND
OAKV	OAKVILLE
OBES	OBESITY
OBIT	OBITUAR
OBLIG	OBLIGATION
OBSTR	OBSTRUCTIVE
OCCAS	OCCASION
OCCUP	OCCUPANCY
OCCUP	OCCUPATION
OCCUP	OCCUPIED
OCCUR	OCCUR
OCEAN	OCEAN
OCEAN	OCEANIC
OCEANOGR	OCEANOGRAPHY
OCEANOL	OCEANOLOGY
OCTAG	OCTAGON
OCT	OCTOBER
OCUL	OCULIST
OCULOMOT	OCULOMOTOR
OFFER	OFFER
OFFPR	OFFPRINT
OFFSH	OFFSHOOT
OGDENSBG	OGDENSBURG
OILW	OILWELL
OKLA	OKLAHOMA
OLDS	OLDSMOBILE
OLDTIM	OLDTIM
OLFACTOM	OLFACTOMETER
OLIGOGENET	OLIGOGENETIC
OLIGOSACCH	OLIGOSACCHARIDE
OLYMP	OLYMPIC
ONCOFET	ONCOFETAL
ONCOG	ONCOGENES
ONCOG	ONCOGENI
ONCOL	ONCOLOGY
ONOMASIOL	ONOMASIOLOGY
ONT	ONTARIO
OPEN	OPENING
OPERANT	OPERANT
OPHTHALMOL	OPHTHALMOLOGY
OPIN	OPINION
OPPOR	OPPORTUNITY
OPPOS	OPPOSITION
OPT	OPTIC
OPTIM	OPTIMAL
OPTIMIST	OPTIMISTIC
OPTIM	OPTIMIZATION
OPTOACOUST	OPTOACOUSTIC
OPTOELECTRON	OPTOELECTRON
OPTOMECH	OPTOMECHANI
OPTRON	OPTRONICS
ORCHARD	ORCHARD
ORCH	ORCHESTR
ORD	ORDINANC
ORDINOL	ORDINOLOGY
OR	OREGON
ORGANBUILD	ORGANBUILD
ORG	ORGANIC
ORG	ORGANISM
ORGAN	ORGANIZE
ORGAN	ORGANIZING
ORGANOCHLOR	ORGANOCHLORINE
ORGANOFLUOR	ORGANOFLUORINE
ORGANOG	ORGANOGEN
ORGANOMET	ORGANOMETALLIC
ORGANOSULF	ORGANOSULFER
ORGON	ORGONOMY
ORIENT	ORIENTAL
ORIENTAT	ORIENTATION
ORIENTEER	ORIENTEERING
ORIENT	ORIENTIQUE
ORIG	ORIGIN
ORNAM	ORNAMENTAL
ORNITHOL	ORNITHOLOGY
OROFAC	OROFACIAL
ORTHOD	ORTHODONT
ORTHOMOL	ORTHOMOLECULARAR
ORTHONT	ORTHONTIC
ORTHOPAEDAGOG	ORTHOPAEDAGOGI
ORTHOP	ORTHOPAEDI
ORTHOP	ORTHOPED
ORTHOPSYCHIATR	ORTHOPSYCHIATRI
ORTHOPT	ORTHOPTIC
ORTHOT	ORTHOTICS
OSMOREGUL	OSMOREGUL
OSSET	OSSETIAN
OSTDTSCH	OSTDEUTSCH
OSTEOARCHAEOL	OSTEOARCHAEOL
OSTEOARTHR	OSTEOARTHRITIS
OSTEOGENES	OSTEOGENESIS
OSTEOL	OSTEOLOGY
OSTEOPATH	OSTEOPATHIC
OSTEOPOROS	OSTEOPOROSIS
OTT	OTTAWA
OUTBOARD	OUTBOARD
OUTFIT	OUTFIT
OUTL	OUTLINE
OUTS	OUTSIDE
OUTST	OUTSTANDING
OUTW	OUTWARD
OVERCROWD	OVERCROWDING
OVERL	OVERLAND
OVERL PARK	OVERLAND PARK
OVERS	OVERSIGHT
OVERT	OVERTURE
OVERV	OVERVIEW
OVERVOLT	OVERVOLTAGE
OVUL	OVULATION
OWN	OWNED
OWN	OWNER
OWNERSH	OWNERSHIP
OXF	OXFORD
OXFS	OXFORDSHIRE
OXID	OXIDANT
OXID	OXIDATION
OXID	OXIDISING
OXID	OXIDIZING
OXIDOREDUCT	OXIDOREDUCTION
OXON	OXONIENSIA
OXYG	OXYGEN
PACEMAK	PACEMAKER
PAC	PACIFIC
PACKAG	PACKAG
PACK	PACKER
PACK	PACKET
PACK	PACKING
PACKINGH	PACKINGHOUSE
PAEDAGOG	PAEDAGOGI
PAEDIATR	PAEDIATRI
PAEDOPSYCHIATR	PAEDOPSYCHIATRI
PAINT	PAINT
PAINTB	PAINTBALL
PAK	PAKISTAN
PALAEARCT	PALAEARCTIC
PALAENTHROPOL	PALAENTHROPOLOGY
PALAEOBOT	PALAEOBOTAN
PALAEOCLIM	PALAEOCLIMAT
PALAEOCLIMATOL	PALAEOCLIMATOLOGY
PALAEOECOL	PALAEOECOLOGY
PALAEOGEOGR	PALAEOGEOGRAPHY
PALAEOICHTHYOL	PALAEOICHTHYOLOGICAL
PALAEONTOGR	PALAEONTOGRAPHY
PALAEONTOL	PALAEONTOLOGY
PALAEOZ	PALAEOZOIC
PALEARCT	PALEARCTIC
PALEOBOT	PALEOBOTANI
PALEOCARPOL	PALEOCARPOLOGY
PALEOCEANOGR	PALEOCEANOGRAPHY
PALEOENVIRON	PALEOENVIRONMENT
PALEOETHNOL	PALEOETHNOLOGY
PALEOGEOGR	PALEOGEOGRAF
PALEOLIMNOL	PALEOLIMNOLOGY
PALEOPATHOL	PALEOPATHOLOGY
PALEOSURF	PALEOSURFAC
PALEOVISITOL	PALEOVISITOLOGY
PALEOZ	PALEOZOIC
PALLIAT	PALLIATIVE
PALMERST	PALMERSTON
PALMERST N	PALMERSTON NORTH
PALM	PALMETTO
PAM	PAMPHLET
PANEUR	PANEUROPEAN
PANAM	PANAMERICAN
PANCREAT	PANCREATIC
PANCREAT	PANCREATITIS
PANCREATOL	PANCREATOLOGY
PANEUR	PANEUROPEAN
PANHAND	PANHAND
PANJ	PANJABI
PANOPT	PANOPTIC
PANOR	PANORAMIC
PAP	PAPER
PAPERB	PAPERBACK
PAPERMACH	PAPERMACHIN
PAPERMAK	PAPERMAK
PNG	PAPUA NEW GUINEA
PAQUETV	PAQUETVILLE
PARACLIN	PARACLINIC
PARALLELOGR	PARALLELOGRAMME
PARAPHERN	PARAPHERNALIA
PARAPLEG	PARAPLEGIC
PARAPUB	PARAPUBLIC
PARASIT	PARASIT
PARASIT	PARASITI
PARASIT	PARASITOID
PARASITOL	PARASITOLOGY
PARATHYR	PARATHYROID
PARENT	PARENTAL
PARENTER	PARENTERAL
PARENT	PARENTHOOD
PARENT	PARENTING
PARISH	PARISHIONER
PARK	PARK
PARKW	PARKWAY
PARLEM	PARLEMENT
PARLIAM	PARLIAMENT
PARNASS	PARNASSUS
PAROL	PAROL
PARTAX	PARTAXIS
PARTIAL	PARTIAL
PART	PARTICLE
PART	PARTICUL
PARTIS	PARTISAN
PARTN	PARTNER
PARTNERSH	PARTNERSHIP
PASSAR	PASSARELLA
PASS	PASSED
PASSENG	PASSENGER
PASSER	PASSERELLA
PASSIV	PASSIVE
PASSPT	PASSPORT
PASTOR	PASTOR
PASTOR	PASTORAL
PASTRYCOOK	PASTRYCOOK
PATCHW	PATCHWORK
PAT	PATENT
PAT	PATENTE
PATHFIND	PATHFIND
PATHOCHEM	PATHOCHEMISTRY
PATHOPHYSIOL	PATHOPHYSIOLOGY
PATHW	PATHWAY
PATRIOT	PATRIOT
PAWTUCK	PAWTUCKET
PAY	PAYANT
PAYM	PAYMENT
PAYR	PAYROLL
PEAC	PEACEFUL
PEACEMAK	PEACEMAKER
PEASANT	PEASANT
PEATL	PEATLAND
PEDESTR	PEDESTRIAN
PEDOD	PEDODON
PEDORTH	PEDORTHICS
PEEL	PEELING
PEEN	PEEN
PELARG	PELARGONIUM
PEMB	PEMBROKE
PEMBS	PEMBROKESHIRE
PENAL	PENAL
PENEOL	PENEOLOGY
PA	PENNSYLVANIA
PENOL	PENOLOGY
PENSION	PENSIONER
PENT	PENTANE
PENULT	PENULTIMATE
PEPSINOG	PEPSINOGEN
PERCENT	PERCENTAGE
PERCEPT	PERCEPTION
PERCEPT	PERCEPTUAL
PERENN	PERENNIAL
PERFECT	PERFECTION
PERFLUOROCHEM	PERFLUOROCHEM
PERFORM	PERFORMABILITY
PERFORM	PERFORMANCE
PERFORM	PERFORMER
PERFORM	PERFORMING
PERICARD	PERICARDIAL
PERIGLAC	PERIGLACIAL
PERINAT	PERINATAL
PERIOPER	PERIOPERAT
PERIPHER	PERIPHER
PERISC	PERISCOP
PERISH	PERISHABLE
PERIT	PERITONEAL
PERMAFR	PERMAFROST
PERM	PERMANENT
PERMEAT	PERMEATION
PERMUT	PERMUT
PERQUIS	PERQUISIT
PERS	PERSONALIST
PERSUAS	PERSUASI
PERTAIN	PERTAIN
PERTIN	PERTINENT
PETERB	PETERBOROUGH
PETERH	PETERHEAD
PETERSF	PETERSFIELD
PETITION	PETITIONER
PETROANAL	PETROANALY
PETROCHEM	PETROCHEM
PETROGL	PETROGLYPH
PETROGR	PETROGRAPHY
PETROPHYS	PETROPHYSICSAL
PHAENOL	PHAENOLOGY
PHANEROZ	PHANEROZOIC
PHARM	PHARMACEUTICAL
PHARM	PHARMACI
PHARM	PHARMACO
PHARMACOCHEM	PHARMACOCHEMISTRY
PHARMACOCINET	PHARMACOCINETI
PHARMACOEPIDEMIOL	PHARMACOEPIDEMIOL
PHARMACOGN	PHARMACOGNOS
PHARMACOKINET	PHARMACOKINETI
PHARMACOL	PHARMACOLOGY
PHARMACOMED	PHARMACOMED
PHARMACOMET	PHARMACOMETRIC
PHARMACOPSYCHIATR	PHARMACOPSYCHIATRI
PHARMACOTHER	PHARMACOTHERAP
PHARMACOVIGIL	PHARMACOVIGILANCE
PHARM	PHARMACY
PHEAS	PHEASANT
PHENOL	PHENOLOGY
PHENOM	PHENOMENA
PHENOM	PHENOMENON
PHILA	PHILADELPHIA
PHILAML	PHILAMLIFE
PHILAT	PHILATEL
PHILIPP	PHILIPPIN
PHILOL	PHILOLOGY
PHILON	PHILONIC
PHONEC	PHONECARD
PHOSPHOPROT	PHOSPHOPROTEIN
PHOTOENGRAV	PHOTOENGRAVER
PHOTOACOUST	PHOTOACOUSTIC
PHOTOBIOCHEM	PHOTOBIOCHEMISTRY
PHOTOBIOPHYS	PHOTOBIOPHYSI
PHOTOCATAL	PHOTOCATALYS
PHOTOCHEM	PHOTOCHEMISTRY
PHOTOCOAGUL	PHOTOCOAGULATION
PHOTOCOND	PHOTOCONDUCT
PHOTOCONVERS	PHOTOCONVERSION
PHOTODERMATOL	PHOTODERMATOLOGY
PHOTODYN	PHOTODYNAMI
PHOTOEFF	PHOTOEFFECT
PHOTOELAST	PHOTOELASTIC
PHOTOELECTR	PHOTOELECTRIC
PHOTOELECTROCHEM	PHOTOELECTROCHEMISTRY
PHOTOELECTRON	PHOTOELECTRONICS
PHOTOEMISS	PHOTOEMISSION
PHOTOFABR	PHOTOFABRICATION
PHOTOFUNCT	PHOTOFUNCTION
PHOTOGENER	PHOTOGENERATI
PHOTOHIST	PHOTOHISTORIAN
PHOTOIMMUNOL	PHOTOIMMUNOLOGY
PHOTOIONIS	PHOTOIONIS
PHOTOMECH	PHOTOMECHANICS
PHOTOMED	PHOTOMEDICINE
PHOTOMICROGR	PHOTOMICROGRAPHY
PHOTOPERIOD	PHOTOPERIODI
PHOTOPOLYM	PHOTOPOLYMER
PHOTOSENSIT	PHOTOSENSITIVE
PHOTOSYNTH	PHOTOSYNTHESIS
PHOTOSYST	PHOTOSYSTEM
PHOTOTH	PHOTOTHEQUE
PHOTOTRANSFORM	PHOTOTRANSFORMATION
PHOTOVOLT	PHOTOVOLTAIC
PHRASEOL	PHRASEOLOGY
PHRENOL	PHRENOLOGY
PHYCOL	PHYCOLOGY
PHYS	PHYSICSA
PHYS	PHYSICSIST
PHYS	PHYSICSO
PHYSICSOCHEM	PHYSICSOCHEM
PHYSICSOMATH	PHYSICSOMATHEMAT
PHYSICSOTECH	PHYSICSOTECHNICS
PHYS	PHYSICSS
PHYTODEPUR	PHYTODEPURATION
PHYTOECOL	PHYTOECOLOGY
PHYTOHORM	PHYTOHORMONE
PHYTOHYG	PHYTOHYGIEN
PHYTOLITH	PHYTOLITHARIEN
PHYTOPHARM	PHYTOPHARMAC
PHYTOPHYSIOL	PHYTOPHYSIOLOGY
PICK	PICK
PICT	PICTORIAL
PICT	PICTURE
PIKEV	PIKEVILLE
PILGR	PILGRIM
PILGR	PILGRIMAG
PILLOWC	PILLOWCASE
PIONEER	PIONEERING
PIPEWELD	PIPEWELD
PIP	PIPING
PIROPLASM	PIROPLASMOSIS
PISCIC	PISCICULT
PITTSBG	PITTSBURG
PITTSFLD	PITTSFIELD
PITUIT	PITUITARY
PLACENT	PLACENTAL
PLANET	PLANET
PLAINSM	PLAINSMAN
PLANET	PLANETARIUM
PLANETOL	PLANETOLOGY
PLAN	PLANNED
PLAN	PLANNER
PLAN	PLANNING
PLANT	PLANTATION
PLANT	PLANTED
PLANTGROW	PLANTGROWING
PLANT	PLANTING
PLANTMAK	PLANTMAK
PLASMON	PLASMONICS
PLASTER	PLASTER
PLATEMAK	PLATEMAK
PLATF	PLATFORM
PLAT	PLATING
PLATTSBG	PLATTSBURGH
PLATTSV	PLATTSVILLE
PLAY	PLAY
PLAYB	PLAYBOOK
PLAYCENT	PLAYCENTRE
PLAY	PLAYING
PLAYLEAD	PLAYLEADER
PLAYMARK	PLAYMARKET
PLAYSTN	PLAYSTATION
PLEAD	PLEADING
PLEAS	PLEASANT
PLEAS	PLEASURE
PLEAT	PLEATING
PLOUGHM	PLOUGHMAN
PLOUGSH	PLOUGSHARE
PLUMB	PLUMB
PLURIDISCIP	PLURIDISCIPLINE
PNEUMOCON	PNEUMOCONIOSIS
PNEUMOTRANSP	PNEUMOTRANSPORT
POCKETB	POCKETBOOK
POCKETB	POCKETBOOK
POIET	POIETICS
POINT PLEAS	POINT PLEASANT
POL	POLAND
POLARIM	POLARIMETER
POLARIZ	POLARIZAT
POLEM	POLEMICAL
POLIC	POLICING
POLICYHOLD	POLICYHOLDER
POLIO	POLIOMYELIT
POL	POLISH
POLL	POLLED
POLLINAT	POLLINATION
POLL	POLLING
POLLUT	POLLUTANT
POLLUT	POLLUTION
POLYACRYL	POLYACRYL
POLYAT	POLYATOMIC
POLYCH	POLYCHAETE
POLYCLIN	POLYCLINI
POLYCRYST	POLYCRYSTALLI
POLYCULT	POLYCULTUR
POLYCYCL	POLYCYCLIC
POLYEST	POLYESTER
POLYETHYL	POLYETHYLENE
POLYGR	POLYGRAPHY
POLYIM	POLYIMIDE
POLYM	POLYMER
POLYMICROB	POLYMICROBIAL
POLYMORPH	POLYMORPHISM
POLYMORPHONUCL	POLYMORPHONUCLEAR
POLYN	POLYNESI
POLYPEPT	POLYPEPTIDES
POLYPROPYL	POLYPROPYLENE
POLYSTYR	POLYSTYRENE
POLYTECH	POLYTECHNICS
POLYTHEMAT	POLYTHEMATICAL
POMOL	POMOLOGY
PONDKEEP	PONDKEEPER
PONTYP	PONTYPOOL
POOL	POOLED
POPUL	POPULATION
PORCUP	PORCUPINE
POROSIM	POROSIMETER
PORPHYR	PORPHYRIN
PORT ELIZAB	PORT ELIZABETH
PH	PORT HARCOURT
PORT HUEN	PORT HUENEME
PORT SPAIN	PORT OF SPAIN
PR	PORTO RICO
PORTSM	PORTSMOUTH
POSITION	POSITIONING
POSIT	POSITIVE
POSSESS	POSSESS
POST	POSTAGE
POST	POSTAL
POSTC	POSTCARD
POSTCONF	POSTCONFERENCE
POSTDR	POSTDOCTOR
POSTGRAD	POSTGRADUATE
POST	POSTING
POSTMAST	POSTMASTER
POSTMOD	POSTMODERN
POSTMYOCARD	POSTMYOCARDIAL
POSTOPER	POSTOPERATIV
PS	POSTSCRIPT
POSTSECOND	POSTSECOND
POTASHV	POTASHVILLE
POTENTIAL	POTENTIALLY
POTOM	POTOMAC
POULT	POULTRY
POULTRYM	POULTRYMAN
POUND	POUNDING
POWERB	POWERBOAT
POWERB	POWERBOATING
POWERLIFT	POWERLIFT
POWERPL	POWERPLANT
PRACT	PRACTICE
PRAEP	PRAEPARATION
PRAES	PRAESIDENT
PRAGMAT	PRAGMATICS
PRAIRIE VAL	PRAIRIE VALLEYS
PRANC	PRANC
PRAY	PRAY
PREACH	PREACHING
PREBIOL	PREBIOLOGY
PRECAST	PRECAST
PRECAUT	PRECAUTION
PRECED	PRECED
PRECEPT	PRECEPTOR
PRECIP	PRECIPITATION
PRECIS	PRECISION
PRECLIN	PRECLINIC
PRECONC	PRECONCENTRAT
PRECOND	PRECONDITIONED
PREDAT	PREDATOR
PREDECESS	PREDECESS
PREDENT	PREDENTAL
PREDICT	PREDICTION
PREDOM	PREDOMINATELY
PREFECT	PREFECTURE
PREFER	PREFER
PREGERIATR	PREGERIATRIC
PREHIST	PREHISTORI
PRELEUK	PRELEUKEMI
PRELIM	PRELIMINAR
PREMALIG	PREMALIGN
PREMATUR	PREMATURITY
PRENAT	PRENATAL
PREP	PREPARATION
PREPR	PREPRINT
PREREFUND	PREREFUND
PRESBYT	PRESBYTERIAN
PRESCH	PRESCHOOL
PRESCR	PRESCRIB
PRESCR	PRESCRIPTION
PRESENT	PRESENT
PRESERV	PRESERVATION
PRES	PRESIDEN
PRES	PRESIDING
PRESS	PRESS
PRESS	PRESSURE
PRESS	PRESSURIZE
PRESTRESS	PRESTRESS
PRESYST	PRESYSTEM
PRETREAT	PRETREATMENT
PRETR	PRETRIAL
PREVAIL	PREVAIL
PREVAL	PREVALENCE
PREV	PREVENT
PREVIS	PREVIS
PRICEB	PRICEBOOK
PRIEST	PRIESTLEY
PRIM	PRIMARY
PRIMIT	PRIMITIVE
PEI	PRINCE EDWARD ISLAND
PRINCES RISB	PRINCES RISBOROUGH
PRINCET	PRINCETON
PRINC	PRINCIPAL
PRINC	PRINCIPLE
PRINT	PRINTED
PRINT	PRINTER
PRINT	PRINTING
PRINTMAK	PRINTMAK
PRIOR	PRIORITY
PRISON	PRISON
PRIV	PRIVACY
PRIZE	PRIZE
PROBAB	PROBABILIT
PROBAB	PROBABLISTIC
PROBAT	PROBATION
PROCED	PROCEDURAL
PROCED	PROCEDURE
PROC	PROCEEDINGS
PROCESS	PROCESS
PROCLAM	PROCLAMATION
PROCTOL	PROCTOLOGY
PROCURE	PROCUREMENT
PROD	PRODUCTION
PRODUCTRON	PRODUCTRONICSC
PROF	PROFESSION
PROFIC	PROFICIENCY
PROFIL	PROFILACT
PROFIT	PROFITING
PROGENIT	PROGENITOR
PROGRAM	PROGRAM
PROGRAM	PROGRAMMED
PROGRAM	PROGRAMMER
PROGRAM	PROGRAMMING
PROG	PROGRESS
PROJ	PROJECT
PROLET	PROLETARIAN
PROLIF	PROLIFERATION
PROLONG	PROLONG
PROMIN	PROMINENT
PROMIS	PROMISING
PROMOT	PROMOTION
PRONOUNC	PRONOUNC
PROOFREAD	PROOFREADER
PROPAG	PROPAGAND
PROPAG	PROPAGATION
PROP	PROPERTY
PROPHET	PROPHET
PROPHYL	PROPHYLACT
PROPOS	PROPOS
PROPR	PROPRIET
PROPULS	PROPULSION
PROPYL	PROPYLENE
PROSEC	PROSECUT
PROSPECT	PROSPECT
PROSPER	PROSPERIT
PROSTHES	PROSTHESIS
PROSTHET	PROSTHETIC
PROSTHODONT	PROSTHODONT
PROT	PROTECTION
PROTHES	PROTHESIS
PROTOBIOL	PROTOBIOLOGY
PROTOC	PROTOCOL
PROTOTYP	PROTOTYPING
PROTUN	PROTUNING
PROV	PROVINC
PROVIS	PROVISION
PROVOK	PROVOKING
PRUDENT	PRUDENTIAL
PSEUDEPIGR	PSEUDEPIGRAPHA
PSYCH	PSYCHICS
PSYCHOACT	PSYCHOACTIVE
PSYCHOANAL	PSYCHOANAL
PSYCHOCHEM	PSYCHOCHEMISTRY
PSYCHODYN	PSYCHODYNAMI
PSYCHOEDUC	PSYCHOEDUCA
PSYCHOENDOCR	PSYCHOENDOCRINE
PSYCHOENDOCRINOL	PSYCHOENDOCRINOLOGY
PSYCHOGERIATR	PSYCHOGERIATRIC
PSYCHOHIST	PSYCHOHISTOR
PSYCHOLINGUIST	PSYCHOLINGUISTIC
PSYCHONEUROENDOCR	PSYCHONEUROENDOCRINE
PSYCHOPATH	PSYCHOPATHIC
PSYCHOPATHOL	PSYCHOPATHOLOGY
PSYCHOPHARMACOL	PSYCHOPHARMACOLOGY
PSYCHOPHARM	PSYCHOPHARMAKA
PSYCHOPHYS	PSYCHOPHYSICS
PSYCHOPHYSIOL	PSYCHOPHYSIOLOGY
PSYCHOS	PSYCHOSIS
PSYCHOSOC	PSYCHOSOCIAL
PSYCHOSYNDR	PSYCHOSYNDROM
PSYCHOSYNTH	PSYCHOSYNTHESIS
PTERIDOL	PTERIDOLOGY
PUBL	PUBLICATION
PUBLIC	PUBLICITY
PUBL	PUBLISH
PUERIC	PUERICULTUR
PULM	PULMONAR
PULMONOL	PULMONOLOGY
PUMP	PUMPING
PUNCTUAL	PUNCTUALITY
PUNISHM	PUNISHMENT
PUPPET	PUPPETEER
PURCH	PURCHAS
PURIF	PURIFICATION
PURP	PURPOSE
PURS	PURSUANT
PURS	PURSUIT
PURV	PURVIEW
PUSHC	PUSHCART
PUSH	PUSHING
PUTT	PUTTING
PYROTECH	PYROTECHNICS
QUADRANG	QUADRANGLE
QUADR	QUADRANT
QUADRENN	QUADRENNIAL
QUADRIENN	QUADRIENNIAL
QUALIF	QUALIFYING
QUAL	QUALIT
QUAR	QUARANTINE
QUARR	QUARR
QUARR	QUARRYING
QUART	QUARTER
Q	QUARTERLY
QUASIMARK	QUASIMARKET
QUASIPART	QUASIPARTICLE
QUAT	QUATERNAR
QUEENCHARLOTTEISL	QUEENCHARLOTTEISLANDS
QLD	QUEENSLAND
QUEST	QUESTION
QUILT	QUILT
QUILTW	QUILTWORK
QUINQUENN	QUINQUENNIAL
QUOTA	QUOTATION
RABBIT	RABBIT
RACEH	RACEHORSE
RACK	RACKING
RACQUETB	RACQUETBALL
RADCL	RADCLIFFE
RADIAT	RADIATING
RADIAT	RADIATION
RADIAT	RADIATIVE
RADIC	RADICAL
RADIOACT	RADIOACTIVITY
RADIOCARB	RADIOCARBON
RADIOCHEM	RADIOCHEM
RADIODIAGN	RADIODIAGNOSTIC
RADIOECOL	RADIOECOLOGY
RADIOELECTR	RADIOELECTRIC
RADIOELECTRON	RADIOELECTRONICS
RADIOFREQ	RADIOFREQUENC
RADIOIMMUNOTHER	RADIOIMMUNOTHERAP
RADIOM	RADIOMETER
RADIONAVIG	RADIONAVIGATION
RADIONUCL	RADIONUCLIDE
RADIOPHARM	RADIOPHARMAC
RADIOPHARMACOL	RADIOPHARMACOLOGY
RADIOPHYS	RADIOPHYSICS
RADIOPROT	RADIOPROTECT
RADIOSCI	RADIOSCIENTIST
RADIOSC	RADIOSCOPE
RADIOSENSIT	RADIOSENSITIZER
RADIOSTERIL	RADIOSTERILIZATION
RADNORS	RADNORSHIRE
RAFT	RAFTING
RAID	RAIDER
RAILP	RAILPASS
RAILR	RAILROAD
RAILW	RAILWAY
RAINFOR	RAINFOREST
RAIS	RAISED
RAIS	RAISER
RAIS	RAISING
RALLY	RALLYING
RAMBL	RAMBL
RANGEL	RANGELAND
RANK	RANK
RAQUETB	RAQUETBALL
RAT	RATING
RATION	RATIONAL
REACH	REACH
REACT	REACTING
REACT	REACTION
REACT	REACTIV
REACT	REACTOR
READ	READER
READERSH	READERSHIP
READ	READING
REAG	REAGENT
REAL	REALITY
REALT	REALT
REANIM	REANIMATION
REAR	REARED
REARRANGE	REARRANGE
REASON	REASON
REASSEMBL	REASSEMBL
REASSESS	REASSESSMENT
RECEIPT	RECEIPT
RECEIV	RECEIVE
RECENS	RECENSION
RECENT	RECENTLY
RECEPT	RECEPT
RECEPTEROL	RECEPTEROLOGY
RECERTIF	RECERTIFICAT
RECESS	RECESSION
RECIDIV	RECIDIV
RECIP	RECIPIEN
RECIRC	RECIRCULAT
RECKON	RECKONNER
RECLAM	RECLAMATION
RECLASSIF	RECLASSIFI
RECOGNIT	RECOGNITION
RECOGN	RECOGNIZE
RECOLLECT	RECOLLECT
RECOMB	RECOMBIN
RECOMM	RECOMMEND
RECONCIL	RECONCILIATION
RECONNECT	RECONNECTION
RECONST	RECONSTITUT
RECONSTR	RECONSTRUCT
REC	RECORD
RECOVER	RECOVER
RECREAT	RECREATION
RECRUIT	RECRUIT
RECRYST	RECRYSTALLIZ
RECULTIV	RECULTIVAT
RECURR	RECURRENT
RECURR	RECURRING
RECYCL	RECYCLING
REDB	REDBOOK
REDEEM	REDEEM
REDEMPT	REDEMPTION
REDEMPT	REDEMPTORIST
REDEPLOY	REDEPLOYMENT
REDEV	REDEVELOP
REDISTRIB	REDISTRIBUT
REDUC	REDUCED
REDUCT	REDUCTION
REDW	REDWOOD
REEF	REEFER
REEVAL	REEVALUATION
REF	REFERRAL
REFIN	REFINED
REFIN	REFINER
REFIN	REFINERY
REFIN	REFINING
REFLECT	REFLECTION
REFOR	REFORESTATION
REFORM	REFORMATION
REFORM	REFORMATORY
REFORM	REFORMED
REFORM	REFORMER
REFORMUL	REFORMULATION
REFRACT	REFRACTION
REFRESH	REFRESHER
REFRESH	REFRESHMENT
REFRIG	REFRIG
REFUG	REFUG
REFUND	REFUND
REFURB	REFURBISHMENT
REGEN	REGENER
REGISTRARSH	REGISTRARSHIP
REGRES	REGRESSION
REGUL	REGULAR
REGUL	REGULATION
REIMBURSE	REIMBURSEMENT
REIMPR	REIMPR
REINF	REINFORCE
REINSM	REINSMAN
REINSUR	REINSUR
RELAT	RELATED
RELAT	RELATING
RELAT	RELATION
RELATSH	RELATIONSHIP
RELAT	RELATIVE
RELATIV	RELATIVITY
RELAT	RELATOR
RELAX	RELAXATION
RELEAS	RELEASING
RELIAB	RELIAB
RELOCAT	RELOCAT
REMAIN	REMAIN
REM	REMEDE
REMEDIAT	REMEDIAT
REM	REMEDY
REMEMB	REMEMB
REMIND	REMINDER
REMINER	REMINERALI
REMINISC	REMINISCENCE
REMIT	REMIT
REMN	REMNANT
REMODEL	REMODEL
REMOTE	REMOTE
REMOV	REMOVAL
REMUN	REMUNERATION
REN	RENAL
RENASC	RENASCENCE
RENDER	RENDER
RENEW	RENEWABLE
RENEW	RENEWAL
RENEGOTIAT	RENEGOTIATION
RENORM	RENORMAL
RENT	RENTAL
REPAIR	REPAIRER
REPAIR	REPAIRING
REPAR	REPARATION
REPATR	REPATRIATION
REPAYM	REPAYMENT
REPEL	REPELLENT
REPERT	REPERTORI
REPETIT	REPETITION
REPLAC	REPLACING
REP	REPORT
REP	REPORTED
REPORT	REPORTER
REPORT	REPORTING
REPOS	REPOSITOR
REPRESENT	REPRESENT
REPRESS	REPRESSION
REPR	REPRINT
REPROCESS	REPROCESSING
REPROGR	REPROGRAPHY
REPUB	REPUBLIC
REPUBL	REPUBLICATION
REPUT	REPUTATION
REQ	REQUEST
REQUIR	REQUIREMENT
RES	RESEARCH
RESELL	RESELL
RESERVIST	RESERVIST
RESERV	RESERVOIR
RESETTL	RESETTLEMENT
RESID	RESIDENCY
RESID	RESIDENT
RESIL	RESILIENCE
RESIST	RESIST
RESOLUT	RESOLUTION
RESOLV	RESOLV
RESON	RESON
RESOPHON	RESOPHONIC
RESOUR	RESOURCE
RESPECT	RESPECTING
RESPIR	RESPIRAT
RESPIROL	RESPIROLOGY
RESPOND	RESPONDENT
RESPONSIB	RESPONSIBILIT
RESTIT	RESTITUTION
REST	RESTON
RESTOR	RESTORATION
RESTOR	RESTORATIONIST
RESTOR	RESTORATIVE
RESTOR	RESTORER
RESTRICT	RESTRICTI
RESTRUCT	RESTRUCTUREING
RESULT	RESULTAT
RESURRECT	RESURRECTION
RESUSC	RESUSCITAT
RETAIL	RETAIL
RETAIN	RETAINED
RETENT	RETENTION
RETHINK	RETHINK
RETICUL	RETICULAT
RETICULOENDOTHEL	RETICULOENDOTHELIAL
RETIN	RETIN
RETIRE	RETIREMENT
RETORT	RETORT
RETRAIN	RETRAINING
RETR	RETRIEVAL
RETRIEV	RETRIEVER
RETROFIT	RETROFITT
RETROSP	RETROSPECT
RETURN	RETURNED
RETURN	RETURNER
RETURN	RETURNING
REUN	REUNION
REUTIL	REUTILI
REVEAL	REVEAL
REVEAL	REVEALER
REVEG	REVEGETA
REVEL	REVEL
REVERE	REVERE
REVERS	REVERSIBLE
REV	REVIEW
REVIS	REVISED
REVIS	REVISION
REVISIT	REVISITED
REVITAL	REVITALIZ
REVIVAL	REVIVALIST
REVOLT	REVOLTING
REVOLUC	REVOLUCIJA
REVOLUT	REVOLUTION
REVOLUT	REVOLUTIONARY
REVOLV	REVOLVING
REWARD	REWARD
REYK	REYKJAVIK
RHEODYN	RHEODYNAMIC
RHETOR	RHETORIC
RI	RHODE ISLAND
RHOD	RHODESIA
RHOD	RHODESIA
RHYTHM	RHYTHM
RHYTM	RHYTMIC
RIBB	RIBBON
RIBOS	RIBOSOMES
RICKETTS	RICKETTSIAL
RID	RIDING
RIFLEM	RIFLEMAN
RITUAL	RITUAL
RIVERD	RIVERDALE
RIVERSYMP	RIVERSYMPOS
RIVERV	RIVERVIEW
ROADBUILD	ROADBUILDER
ROAD	ROADING
ROADMAK	ROADMAKING
ROADRUN	ROADRUNNER
ROAM	ROAMING
ROCHESTER	ROCHESTERIAN
ROCKET	ROCKET
ROCK	ROCKIES
ROCKOL	ROCKOLOGY
ROCKV	ROCKVILLE
RODENTIC	RODENTICIDE
ROENTGENOL	ROENTGENOLOGY
RAGATION	ROGATIONIST
ROLL	ROLL
ROLL	ROLLER
ROMANT	ROMANTI
ROMF	ROMFORD
ROOF	ROOFING
ROTHB	ROTHBERG
ROTORCR	ROTORCRAFT
ROUGH	ROUGHNESS
ROUM	ROUMAN
RUCKS	RUCKSACK
RUM	RUMANIA
RUMMAG	RUMMAGING
RUN	RUNN
RUSH	RUSHING
RUSS	RUSSI
RUTL	RUTLAND
RYTHM	RYTHM
S	SOUTH
SE	SOUTHEAST
SW	SOUTHWEST
SABBATH	SABBATH
SACCHARIF	SACCHARIFICATION
SACKV	SACKVILLE
SACRAM	SACRAMENT
SAF	SAFELY
SAF	SAFETY
SAHAR	SAHARAN
SAILBOAT	SAILBOAT
SAIL	SAILING
SAIL	SAILOR
SALESM	SALESMAN
SALIN	SALINIT
SALISB	SALISBURY
SALMON	SALMONID
SAMARIT	SAMARITAN
SAMPL	SAMPLER
SAMPL	SAMPLING
SANBERNARD	SANBERNARDINO
SDIEGO	SANDIEGO
SANAT	SANATOR
SANDW	SANDWICH
SANG	SANGUIN
SANIT	SANITARI
SANIT	SANITARY
ST MONICA	SANTA MONICA
ST BARBARA	SANTA BARBARA
SARD	SARDINIA
SASK	SASKATCHEWAN
SASKAT	SASKATOON
SATELL	SATELLITE
SATIR	SATIR
SATUR	SATURAT
SAUDI ARAB	SAUDI ARABIA
SAV	SAVING
SCANDAL	SCANDAL
SCAND	SCANDINAVI
SCARB	SCARBOROUGH
SCATT	SCATTER
SCAV	SCAVENG
SCEN	SCENIC
SCEPT	SCEPTIC
SCHAUSAMML	SCHAUSAMMLUNG
SCHED	SCHEDUL
SCH	SCHOLARLY
SCHOLARSH	SCHOLARSHIP
SCHOLAST	SCHOLASTI
SCH	SCHOOL
SCHOON	SCHOONER
SCI	SCIENCE
SCIENTOL	SCIENTOLOGY
SCIENTOMETR	SCIENTOMETRIC
SCINTIGR	SCINTIGRAPHY
SCLER	SCLEROSIS
SCOOT	SCOOTER
SCOREBRD	SCOREBOARD
SCOREB	SCOREBOOK
SCOREC	SCORECARD
SCOTL	SCOTLAND
SCOTSM	SCOTSMAN
SCOTT	SCOTTISH
SCOUT	SCOUT
SCRAPB	SCRAPBOOK
SCRAPP	SCRAPPING
SCREEN	SCREENING
SCREENPR	SCREENPRINT
SCRIBBL	SCRIBBLER
SCR	SCRIBE
SCR	SCRIBER
SCR	SCRIPT
SCR	SCRIPTURE
SCRUT	SCRUTINY
SCUFF	SCUFFL
SCULPT	SCULPT
SCURR	SCURRIL
SEAB	SEABIRD
SEABD	SEABOARD
SEAFAR	SEAFAR
SEAF	SEAFOOD
SEAL	SEALER
SEAL	SEALING
SEAM	SEAMAN
SEAMANSH	SEAMANSHIP
SEAPT	SEAPORT
SEAPOW	SEAPOWER
SEARCH	SEARCHER
SEARCH	SEARCHING
SEARCHL	SEARCHLIGHT
SEAS	SEASON
SEAT	SEATING
SEATR	SEATRADE
SEAW	SEAWAY
SECOND	SECOND
SECR	SECRETAR
SECRET	SECRETION
SECRET	SECRETORY
SECT	SECTI
SECT	SECTOR
SECUL	SECUL
SECUR	SECURE
SEDAT	SEDATION
SEDIMENT	SEDIMENTARY
SEDIMENT	SEDIMENTATION
SEEDL	SEEDLING
SEEK	SEEK
SEGREG	SEGREG
SEISMOGR	SEISMOGRAPHY
SEISMOL	SEISMOLOGY
SEL	SELECTION
SELFORGAN	SELFORGANIZ
SELL	SELLING
SEMANT	SEMANTICS
SEMEIOT	SEMEIOTIC
SEMEST	SEMESTR
SEMICUST	SEMICUSTOM
SEMIANNU	SEMIANNUAL
SEMICOND	SEMICONDUCT
SEMIMAGN	SEMIMAGNETI
SEMIMET	SEMIMETAL
SEMIOCHEM	SEMIOCHEMICAL
SEMISYNTH	SEMISYNTHE
SEMIT	SEMIT
SR	SENIOR
SR	SENIORITY
SENS	SENSING
SENSIT	SENSITIVITY
SENS	SENSOR
SENS	SENSORY
SEP	SEPARATE
SEP	SEPARATION
SEP	SEPARATOR
SEPHAR	SEPHARDI
SEPT	SEPTEMB
SERAPH	SERAPHI
SER	SERIES
SERICIC	SERICICULT
SERIC	SERICULTURE
SERODIAGN	SERODIAGNOS
SERONEGAT	SERONEGATI
SERV	SERVER
SERV	SERVIC
SERV	SERVING
SESQUICENTEN	SESQUICENTENNIAL
SESS	SESSI
SETTL	SETTLEMENT
SETTL	SETTLER
SEVER	SEVERANCE
SEW	SEWAGE
SEX	SEXUAL
SHAD	SHADOW
SHAK	SHAKER
SHAKESPEAR	SHAKESPEAR
SHAP	SHAPER
SHAP	SHAPING
SHAR	SHARED
SHAREHOLD	SHAREHOLD
SHAREMARK	SHAREMARKET
SHAREOWNERSH	SHAREOWNERSHIP
SHAR	SHARING
SHARPSH	SHARPSHOOT
SHEAR	SHEAR
SHEEPFARM	SHEEPFARMING
SHEEPM	SHEEPMAN
SHEETMET	SHEETMETAL
SHEFF	SHEFFIELD
SHELLFISH	SHELLFISH
SHELLFISH	SHELLFISHER
SHELLHARB	SHELLHARBOUR
SHELTER	SHELTER
SHERLOCK	SHERLOCKIAN
SHETL	SHETLAND
SHIELD	SHIELD
SHIFTW	SHIFTWORK
SHIPBROK	SHIPBROKER
SHIPBUILD	SHIPBUILDER
SHIPBUILD	SHIPBUILDING
SHIPM	SHIPMENT
SHIPOWN	SHIPOWNER
SHIPOWN	SHIPOWNING
SHIPP	SHIPP
SHIPREP	SHIPREPAIR
SHOCK	SHOCK
SHOEMAK	SHOEMAKING
SHOOT	SHOOT
SHOPFIT	SHOPFITTER
SHOPFIT	SHOPFITTING
SHOPKEEP	SHOPKEEPER
SHOPP	SHOPPER
SHOPP	SHOPPING
SHOREL	SHORELINE
SHORT	SHORT
SHORTH	SHORTHAND
SHORTL	SHORTLAND
SHOWC	SHOWCASE
SHOW	SHOWER
SHOW	SHOWING
SHOWJUMP	SHOWJUMP
SHOWR	SHOWROOM
SHREDD	SHREDD
SHREVEP	SHREVEPORT
SHROPSH	SHROPSHIRE
SHUTT	SHUTTER
SIB	SIBERIA
SICK	SICK
SIDEW	SIDEWARE
SIFT	SIFT
SIGHT	SIGHTED
SIGHTSEE	SIGHTSEEING
SIGILLOGR	SIGILLOGRAPHY
SIGNAL	SIGNALING
SIGNAL	SIGNALLING
SIGNALM	SIGNALMAN
SIGNIF	SIGNIFICANT
SILIC	SILICAT
SILOX	SILOXANE
SILVERSMITH	SILVERSMITHING
SILVERW	SILVERWARE
SILVIC	SILVICULT
SIMPL	SIMPLIFICATION
SIMUL	SIMULATION
SIND	SINDICAT
SINGAP	SINGAPORE
SING	SINGING
SINISTER	SINISTER
SINK	SINK
SINTER	SINTERING
SITUAT	SITUATION
SIXT	SIXTEEN
SIZZ	SIZZL
SKATEBOARD	SKATEBOARD
SKAT	SKATER
SKAT	SKATING
SKELETOGENES	SKELETOGENESIS
SKELET	SKELETON
SKI	SKI
SKINDIV	SKINDIV
SKIN	SKINNER
SKIPP	SKIPP
SKYDIV	SKYDIV
SKYG	SKYGUIDE
SKYW	SKYWAY
SLAUGHT	SLAUGHTER
SLAUGHTERH	SLAUGHTERHOUSE
SLAUGHT	SLAUGHTERING
SLAV	SLAVIC
SLAV	SLAVISTICS
SLEEP	SLEEPING
SLIMBR	SLIMBRIDGE
SLIM	SLIMM
SMALLHOLD	SMALLHOLDER
SMALLHOLD	SMALLHOLDING
SMELT	SMELTING
SMITHSON	SMITHSONIAN
SMITHT	SMITHTOWN
SMOGFORM	SMOGFORMATION
SMOK	SMOKING
SNIFF	SNIFF
SNOOK	SNOOKER
SNOWBOARD	SNOWBOARD
SNOWD	SNOWDONIA
SNOWMOB	SNOWMOBIL
SOAR	SOARING
SOC	SOCIAL
SOCIAL	SOCIALIS
SOC	SOCIET
SOCIOBIOL	SOCIOBIOLOGY
SOCIOCRIT	SOCIOCRITI
SOCIOECON	SOCIOECONOM
SOCIOL	SOCIOLOGY
SOCIOM	SOCIOMETER
SOCRAT	SOCRATIC
SOFTB	SOFTBALL
SOFTCOVER	SOFTCOVER
SOFTW	SOFTWARE
SOIL	SOILLESS
SOL	SOLAR
SOLDER	SOLDER
SOLICIT	SOLICITOR
SOLIDIF	SOLIDIFIC
SOLLICIT	SOLLICIT
SOLST	SOLSTICE
SOLUT	SOLUTION
SOLV	SOLVENCY
SOMAT	SOMATI
SOMATOSENS	SOMATOSENSOR
SOMATOSTAT	SOMATOSTATIN
SOMERV	SOMERVILLE
SONGB	SONGBOOK
SONOGR	SONOGRA
SOUND	SOUNDING
SOURCEB	SOURCEBOOK
SOURC	SOURCING
S AFR	SOUTH AFRICA
S AM	SOUTH AMERICA
S AUST	SOUTH AUSTRALIA
S CANTERB	SOUTH CANTERBURY
SC	SOUTH CAROLINA
SD	SOUTH DAKOTA
S MELB	SOUTH MELBOURNE
S PAC	SOUTH PACIFIC
S PERTH	SOUTH PERTH
SOUTHAMPT	SOUTHAMPTON
SOUTHEAST	SOUTHEASTERN
SOUTH	SOUTHERN
SOUTHF	SOUTHFIELD
SOUTHL	SOUTHLAND
SOUTHWEST	SOUTHWESTERN
SOVER	SOVEREIGN
SPACECR	SPACECRAFT
SPACEFL	SPACEFLIGHT
SPAN	SPANISH
SPEAK	SPEAK
SPECIAT	SPECIATION
SPECIF	SPECIFIC
SPECIF	SPECIFICATION
SPECIF	SPECIFICITY
SPECIF	SPECIFIER
SPECIF	SPECIFYING
SPECIM	SPECIMEN
SPECT	SPECTACULAR
SPECTR	SPECTRAL
SPECTROCHEM	SPECTROCHEM
SPECTROFLUORIM	SPECTROFLUORIMETER
SPECTROGR	SPECTROGRAPHY
SPECTROM	SPECTROMETER
SPECTRON	SPECTRONOM
SPECTROPOLARIM	SPECTROPOLARIMETER
SPECTROSC	SPECTROSCOP
SPECTR	SPECTRUM
SPECUL	SPECULATIVE
SPECUL	SPECULATOR
SPEEDW	SPEEDWAY
SPELAEOL	SPELAEOLOGY
SPELL	SPELLING
SPEND	SPEND
SPHENIS	SPHENISCID
SPINDL	SPINDL
SPINN	SPINN
SPINTRON	SPINTRONI
SPIRITUAL	SPIRITUALITY
SPOK	SPOKEN
SPOKESM	SPOKESMAN
SPOKESP	SPOKESPERSON
SPONS	SPONSOR
SPONS	SPONSORSHIP
SPORTFISH	SPORTFISH
SPORTMAG	SPORTMAGAZINE
SPORTSL	SPORTSLAND
SPORTSMED	SPORTSMEDICINE
SPORTSW	SPORTSWEAR
SPORTSWOM	SPORTSWOMAN
SPRAY	SPRAYING
SPRINGF	SPRINGFIELD
SPRINK	SPRINKL
SQUASHPLAY	SQUASHPLAYER
STAB	STABILITY
STAB	STABILIZ
STAD	STADIUM
STAFF	STAFF
STAFFS	STAFFORDSHIRE
STAIN	STAIN
STAINL	STAINLESS
STAKEHOLD	STAKEHOLDER
STALK	STALK
STAMP	STAMPING
STAND	STANDARD
STANF	STANFORD
STARBR	STARBRIGHT
STAR	STARING
START	START
START	STARTING
STARV	STARVING
STATEN ISL	STATEN ISLAND
STATEW	STATEWIDE
STN	STATION
STATION	STATION
STAY	STAY
STEAMB	STEAMBOAT
STEAM	STEAMER
STEAMSH	STEAMSHIP
STEELMAK	STEELMAK
STEELWORK	STEELWORKER
STEER	STEERING
STEREOCHEM	STEREOCHEM
STEREODYN	STEREODYNAMICS
STEREOENCEPH	STEREOENCEPHALOTOMY
STEREOGR	STEREOGRAPHY
STEREOSC	STEREOSCOPI
STEREOTACT	STEREOTACTIC
STERIL	STERILITY
STERILIZ	STERILIZATION
STERL	STERLING
STEROIDHORM	STEROIDHORMON
STETHOSC	STETHOSCOPE
STEVEDOR	STEVEDOR
STEWARD	STEWARD
STICKST	STICKSTOFF
STILET	STILETTO
STILLB	STILLBIRTH
STIMUL	STIMULANT
STIMUL	STIMULATION
STITCH	STITCH
STITTSV	STITTSVILLE
STOCH	STOCHASTIC
STOCK	STOCK
STOCKBROK	STOCKBROKER
STOCKHOLD	STOCKHOLD
STOCKL	STOCKLIST
STOCKM	STOCKMAN
STOCKMARK	STOCKMARKET
STOCKT	STOCKTON
STOICHIOM	STOICHIOMETER
STOKHOLD	STOKHOLDING
STONEW	STONEWARE
STOPP	STOPPAGE
STORYB	STORYBOOK
STORYTELL	STORYTELL
STOUFFV	STOUFFVILLE
STOURBR	STOURBRIDGE
STRATF	STRATFORD
STRATIF	STRATIF
STRATIGR	STRATIGRAPHY
STRATOS	STRATOSPHER
STRAWB	STRAWBERRY
STR	STRET
STRETSV	STRETSVILLE
STRENGTH	STRENGTHENING
STRICT	STRICT
STROLL	STROLL
STRUCTRON	STRUCTRONICS
STRUCT	STRUCTURE
STRUGGL	STRUGGL
STUDB	STUDBOOK
STUDENTSH	STUDENTSHIP
STUD	STUDIES
STUD	STUDYING
STYL	STYLING
STYLIST	STYLIST
SUBALT	SUBALTERN
SUBAQUAT	SUBAQUATI
SUBARCT	SUBARCTIC
SUBAT	SUBATOMIC
SUBCELL	SUBCELLULAR
SUBCLIN	SUBCLINIC
SUBCOMM	SUBCOMMISSION
SUBCOMM	SUBCOMMITTEE
SUBCONT	SUBCONTINENT
SUBCONTRACT	SUBCONTRACT
SUBDIV	SUBDIVIS
SUBGR	SUBGROUP
SUBJ	SUBJECT
SUBMAR	SUBMARIN
SUBMERS	SUBMERSIBLE
SUBMICROSC	SUBMICROSCOP
SUBMISS	SUBMISSION
SUBMITT	SUBMITT
SUBNUCL	SUBNUCLEAR
SUBORD	SUBORDINATE
SUBPOPUL	SUBPOPULATION
SUBPROV	SUBPROVINC
SUBSCR	SUBSCRIB
SUBSCR	SUBSCRIPTION
SUBSECR	SUBSECRETAR
SUBSECT	SUBSECTION
SUBSEQ	SUBSEQUEN
SUBSER	SUBSERIES
SUBSIST	SUBSIST
SUBST	SUBSTANC
SUBST	SUBSTANT
SUBSTIT	SUBSTITUTE
SUBSTIT	SUBSTITUTION
SUBSTRUCT	SUBSTRUCTURE
SUBSURF	SUBSURFAC
SUBTERR	SUBTERRANEAN
SUBURB	SUBURBAN
SUBVENT	SUBVENTION
SUCCEED	SUCCEEDING
SUCCESS	SUCCESSFUL
SUCCESSOR	SUCCESSORAL
SUCCUL	SUCCULENT
SUDAN	SUDANESE
SUDAN	SUDANIC
SUDD	SUDDEN
SUFF	SUFFER
SUFFIC	SUFFICIENCY
SUGGEST	SUGGEST
SUITABIL	SUITABILITY
SUMER	SUMERIAN
SUMM	SUMMAR
SUMM	SUMMATIVE
SUMMERFALL	SUMMERFALLOW
SUMMERL	SUMMERLAND
SUNR	SUNRISE
SUNS	SUNSET
SUPERANN	SUPERANNUATION
SUPERCELL	SUPERCELLULAR
SUPERCERAM	SUPERCERAMIC
SUPERCOMPOS	SUPERCOMPOSIT
SUPERCOMPUT	SUPERCOMPUT
SUPERCOND	SUPERCONDUCT
SUPERCRIT	SUPERCRITICAL
SUPERF	SUPERFIC
SUPT	SUPERINTEND
SUPER	SUPERIOR
SUPERMARK	SUPERMARKET
SUPERNAT	SUPERNATURAL
SUPERPLAST	SUPERPLASTIC
SUPERST	SUPERSTORE
SUPERV	SUPERVISING
SUPERV	SUPERVISION
SUPERV	SUPERVISOR
SUPPL	SUPPLEMENT
SUPPLYSH	SUPPLYSHIP
SUPPR	SUPPRESSANT
SUPPR	SUPPRESSION
SUPRAMOL	SUPRAMOLECULAR
SUPRANATL	SUPRANATIONAL
SURF	SURFACE
SURF	SURFACING
SURG	SURGEON
SURG	SURGERY
SURG	SURGIC
SURN	SURNAME
SURPRIS	SURPRISING
SURREAL	SURREALIST
SURROG	SURROGAT
SURROUND	SURROUNDING
SURV	SURVEY
SURVIV	SURVIV
SUSQUEHAN	SUSQUEHANNA
SUSTAIN	SUSTAIN
SUTHERL	SUTHERLAND
SWANS	SWANSEA
SWAZIL	SWAZILAND
SWED	SWEDEN
SWED	SWEDISH
SWEEPST	SWEEPSTAKE
SWEETEN	SWEETEN
SWIM	SWIM
SWING	SWINGER
SWING	SWINGING
SWITCH	SWITCH
SWITCHB	SWITCHBOARD
SWITCHG	SWITCHGEAR
SWITZ	SWITZERLAND
SYD	SYDNEY
SYLVIC	SYLVICULT
SYMPH	SYMPHONY
SYNAG	SYNAGOGUE
SYNCHRON	SYNCHRONIZE
SYND	SYNDIC
SYNDROMOL	SYNDROMOLOGY
SYNERG	SYNERGY
SYNON	SYNONYM
SYNOP	SYNOPSIS
SYST	SYSTEM
SABBATH	SABBATH
SACCHARIF	SACCHARIFICATION
SACKV	SACKVILLE
SACRAM	SACRAMENT
SAF	SAFELY
SAF	SAFETY
SAHAR	SAHARAN
SAILBOAT	SAILBOAT
SAIL	SAILING
SAIL	SAILOR
SALESM	SALESMAN
SALIN	SALINIT
SALISB	SALISBURY
SALMON	SALMONID
SAMARIT	SAMARITAN
SAMPL	SAMPLER
SAMPL	SAMPLING
SANBERNARD	SANBERNARDINO
S DIEGO	SAN DIEGO
SANAT	SANATOR
SANDW	SANDWICH
SANG	SANGUIN
SANIT	SANITARI
SANIT	SANITARY
ST MONICA	SANTA MONICA
ST BARBARA	SANTA BARBARA
SARD	SARDINIA
SASK	SASKATCHEWAN
SASKAT	SASKATOON
SATELL	SATELLITE
SATIR	SATIR
SATUR	SATURAT
SAUDI ARAB	SAUDI ARABIA
SAV	SAVING
SCANDAL	SCANDAL
SCAND	SCANDINAVI
SCARB	SCARBOROUGH
SCATT	SCATTER
SCAV	SCAVENG
SCEN	SCENIC
SCEPT	SCEPTIC
SCHAUSAMML	SCHAUSAMMLUNG
SCHED	SCHEDUL
SCH	SCHOLARLY
SCHOLARSH	SCHOLARSHIP
SCHOLAST	SCHOLASTI
SCH	SCHOOL
SCHOON	SCHOONER
SCI	SCIENCE
SCI	SCIENT
SCIENTOL	SCIENTOLOGY
SCIENTOMETR	SCIENTOMETRIC
SCINTIGR	SCINTIGRAPHY
SCLER	SCLEROSIS
SCOOT	SCOOTER
SCOREBRD	SCOREBOARD
SCOREB	SCOREBOOK
SCOREC	SCORECARD
SCOTL	SCOTLAND
SCOTSM	SCOTSMAN
SCOTT	SCOTTISH
SCOUT	SCOUT
SCRAPB	SCRAPBOOK
SCRAPP	SCRAPPING
SCREEN	SCREENING
SCREENPR	SCREENPRINT
SCRIBBL	SCRIBBLER
SCR	SCRIBE
SCR	SCRIBER
SCR	SCRIPT
SCR	SCRIPTURE
SCRUT	SCRUTINY
SCUFF	SCUFFL
SCULPT	SCULPT
SCURR	SCURRIL
SEAB	SEABIRD
SEABD	SEABOARD
SEAFAR	SEAFAR
SEAF	SEAFOOD
SEAL	SEALER
SEAL	SEALING
SEAM	SEAMAN
SEAMANSH	SEAMANSHIP
SEAPT	SEAPORT
SEAPOW	SEAPOWER
SEARCH	SEARCHER
SEARCH	SEARCHING
SEARCHL	SEARCHLIGHT
SEAS	SEASON
SEAT	SEATING
SEATR	SEATRADE
SEAW	SEAWAY
SECOND	SECOND
SECR	SECRETAR
SECRET	SECRETION
SECRET	SECRETORY
SECT	SECTI
SECT	SECTOR
SECUL	SECUL
SECUR	SECUR
SEDAT	SEDATION
SEDIMENT	SEDIMENTARY
SEDIMENT	SEDIMENTATION
SEEDL	SEEDLING
SEEK	SEEK
SEGREG	SEGREG
SEISMOGR	SEISMOGRAPHY
SEISMOL	SEISMOLOGY
SEL	SELECT
SELFORGAN	SELFORGANIZ
SELL	SELLING
SEMANT	SEMANTICS
SEMEIOT	SEMEIOTIC
SEMEST	SEMESTR
SEMICUST	SEMICUSTOM
SEMIANNU	SEMIANNUAL
SEMICOND	SEMICONDUCT
SEMIMAGN	SEMIMAGNETI
SEMIMET	SEMIMETAL
SEMIOCHEM	SEMIOCHEMICAL
SEMISYNTH	SEMISYNTHE
SEMIT	SEMIT
SR	SENIOR
SR	SENIORITY
SENS	SENSING
SENSIT	SENSITIVITY
SENS	SENSOR
SENS	SENSORY
SEP	SEPARATE
SEP	SEPARATION
SEP	SEPARATOR
SEPHAR	SEPHARDI
SEPT	SEPTEMB
SERAPH	SERAPHI
SER	SERIA
SERICIC	SERICICULT
SERIC	SERICULTURE
SER	SERIES
SERODIAGN	SERODIAGNOS
SERONEGAT	SERONEGATI
SERV	SERVER
SERV	SERVIC
SERV	SERVING
SESQUICENTEN	SESQUICENTENNIAL
SESS	SESSI
SETTL	SETTLEMENT
SETTL	SETTLER
SEVER	SEVERANCE
SEW	SEWAGE
SEX	SEXUAL
SHAD	SHADOW
SHAK	SHAKER
SHAKESPEAR	SHAKESPEAR
SHAP	SHAPER
SHAP	SHAPING
SHAR	SHARED
SHAREHOLD	SHAREHOLD
SHAREMARK	SHAREMARKET
SHAREOWNERSH	SHAREOWNERSHIP
SHAR	SHARING
SHARPSH	SHARPSHOOT
SHEAR	SHEAR
SHEEPFARM	SHEEPFARMING
SHEEPM	SHEEPMAN
SHEETMET	SHEETMETAL
SHEFF	SHEFFIELD
SHELLFISH	SHELLFISH
SHELLFISH	SHELLFISHER
SHELLHARB	SHELLHARBOUR
SHELTER	SHELTER
SHERLOCK	SHERLOCKIAN
SHETL	SHETLAND
SHIELD	SHIELD
SHIFTW	SHIFTWORK
SHIPBROK	SHIPBROKER
SHIPBUILD	SHIPBUILDER
SHIPBUILD	SHIPBUILDING
SHIPM	SHIPMENT
SHIPOWN	SHIPOWNER
SHIPOWN	SHIPOWNING
SHIPP	SHIPP
SHIPREP	SHIPREPAIR
SHOCK	SHOCK
SHOEMAK	SHOEMAKING
SHOOT	SHOOT
SHOPFIT	SHOPFITTER
SHOPFIT	SHOPFITTING
SHOPKEEP	SHOPKEEPER
SHOPP	SHOPPER
SHOPP	SHOPPING
SHOREL	SHORELINE
SHORT	SHORTAGE
SHORTH	SHORTHAND
SHORTL	SHORTLAND
SHOWC	SHOWCASE
SHOW	SHOWER
SHOW	SHOWING
SHOWJUMP	SHOWJUMP
SHOWR	SHOWROOM
SHREDD	SHREDD
SHREVEP	SHREVEPORT
SHROPSH	SHROPSHIRE
SHUTT	SHUTTER
SIB	SIBERIA
SICK	SICK
SIDEW	SIDEWARE
SIFT	SIFT
SIGHT	SIGHTED
SIGHTSEE	SIGHTSEEING
SIGILLOGR	SIGILLOGRAPHY
SIGNAL	SIGNALING
SIGNAL	SIGNALLING
SIGNALM	SIGNALMAN
SIGNIF	SIGNIFICANT
SILIC	SILICAT
SILOX	SILOXANE
SILVERSMITH	SILVERSMITHING
SILVERW	SILVERWARE
SILVIC	SILVICULT
SIMPL	SIMPLIF
SIMUL	SIMULATION
SIND	SINDICAT
SINGAP	SINGAPORE
SING	SINGING
SINISTER	SINISTER
SINK	SINK
SINTER	SINTERING
SITUAT	SITUATION
SIXT	SIXTEEN
SIZZ	SIZZL
SKATEBOARD	SKATEBOARD
SKAT	SKATER
SKAT	SKATING
SKELETOGENES	SKELETOGENESIS
SKELET	SKELETON
SKI	SKI
SKINDIV	SKINDIV
SKIN	SKINNER
SKIPP	SKIPP
SKYDIV	SKYDIV
SKYG	SKYGUIDE
SKYW	SKYWAY
SLAUGHT	SLAUGHTER
SLAUGHTERH	SLAUGHTERHOUSE
SLAUGHT	SLAUGHTERING
SLAV	SLAVIC
SLAV	SLAVISTICS
SLEEP	SLEEPING
SLIMBR	SLIMBRIDGE
SLIM	SLIMM
SMALLHOLD	SMALLHOLDER
SMALLHOLD	SMALLHOLDING
SMELT	SMELTING
SMITHSON	SMITHSONIAN
SMITHT	SMITHTOWN
SMOGFORM	SMOGFORMATION
SMOK	SMOKING
SNIFF	SNIFF
SNOOK	SNOOKER
SNOWBOARD	SNOWBOARD
SNOWD	SNOWDONIA
SNOWMOB	SNOWMOBIL
SOAR	SOARING
SOC	SOCIAL
SOCIAL	SOCIALIS
SOC	SOCIET
SOCIOBIOL	SOCIOBIOLOGY
SOCIOCRIT	SOCIOCRITI
SOCIOECON	SOCIOECONOM
SOCIOL	SOCIOLOGY
SOCIOM	SOCIOMETER
SOCRAT	SOCRATIC
SOFTB	SOFTBALL
SOFTCOVER	SOFTCOVER
SOFTW	SOFTWARE
SOIL	SOILLESS
SOL	SOLAR
SOLDER	SOLDER
SOLICIT	SOLICITOR
SOLIDIF	SOLIDIFIC
SOLLICIT	SOLLICIT
SOLST	SOLSTICE
SOLUT	SOLUTION
SOLV	SOLVENCY
SOMAT	SOMATI
SOMATOSENS	SOMATOSENSOR
SOMATOSTAT	SOMATOSTATIN
SOMERV	SOMERVILLE
SONGB	SONGBOOK
SONOGR	SONOGRA
SOUND	SOUNDING
SOURCEB	SOURCEBOOK
SOURC	SOURCING
S AFR	SOUTH AFRICA
S AM	SOUTH AMERICA
S AUST	SOUTH AUSTRALIA
S CANTERB	SOUTH CANTERBURY
SC	SOUTH CAROLINA
SD	SOUTH DAKOTA
S MELB	SOUTH MELBOURNE
S PAC	SOUTH PACIFIC
S PERTH	SOUTH PERTH
SOUTHAMPT	SOUTHAMPTON
SOUTHEAST	SOUTHEASTERN
SOUTH	SOUTHERN
SOUTHF	SOUTHFIELD
SOUTHL	SOUTHLAND
SOUTHWEST	SOUTHWESTERN
SOVER	SOVEREIGN
SPACECR	SPACECRAFT
SPACEFL	SPACEFLIGHT
SPAN	SPANISH
SPEAK	SPEAK
SPECIAT	SPECIATION
SPECIF	SPECIFIC
SPECIF	SPECIFICATION
SPECIF	SPECIFICITY
SPECIF	SPECIFIER
SPECIF	SPECIFYING
SPECIM	SPECIMEN
SPECT	SPECTACULAR
SPECTR	SPECTRAL
SPECTROCHEM	SPECTROCHEM
SPECTROFLUORIM	SPECTROFLUORIMETER
SPECTROGR	SPECTROGRAPHY
SPECTROM	SPECTROMETER
SPECTRON	SPECTRONOM
SPECTROPOLARIM	SPECTROPOLARIMETER
SPECTROSC	SPECTROSCOP
SPECTR	SPECTRUM
SPECUL	SPECULATIVE
SPECUL	SPECULATOR
SPEEDW	SPEEDWAY
SPELAEOL	SPELAEOLOGY
SPELL	SPELLING
SPEND	SPEND
SPHENIS	SPHENISCID
SPINDL	SPINDL
SPINN	SPINN
SPINTRON	SPINTRONI
SPIRITUAL	SPIRITUALITY
SPOK	SPOKEN
SPOKESM	SPOKESMAN
SPOKESP	SPOKESPERSON
SPONS	SPONSOR
SPONS	SPONSORSHIP
SPORTFISH	SPORTFISH
SPORTMAG	SPORTMAGAZINE
SPORTSL	SPORTSLAND
SPORTSMED	SPORTSMEDICINE
SPORTSW	SPORTSWEAR
SPORTSWOM	SPORTSWOMAN
SPRAY	SPRAYING
SPRINGF	SPRINGFIELD
SPRINK	SPRINKL
SQUASHPLAY	SQUASHPLAYER
STAB	STABILITY
STAB	STABILIZ
STAD	STADIUM
STAFF	STAFF
STAFFS	STAFFORDSHIRE
STAIN	STAIN
STAINL	STAINLESS
STAKEHOLD	STAKEHOLDER
STALK	STALK
STAMP	STAMPING
STAND	STANDARD
STANF	STANFORD
STARBR	STARBRIGHT
STAR	STARING
START	STARTER
START	STARTING
STARV	STARVING
STATEN ISL	STATEN ISLAND
STATEW	STATEWIDE
STN	STATION
STATION	STATION
STAY	STAY
STEAMB	STEAMBOAT
STEAM	STEAMER
STEAMSH	STEAMSHIP
STEELMAK	STEELMAK
STEELWORK	STEELWORKER
STEER	STEERING
STEREOCHEM	STEREOCHEM
STEREODYN	STEREODYNAMI
STEREOENCEPH	STEREOENCEPHALOTOMY
STEREOGR	STEREOGRAPHY
STEREOSC	STEREOSCOPI
STEREOTACT	STEREOTACTIC
STERIL	STERILITY
STERILIZ	STERILIZATION
STERL	STERLING
STEROIDHORM	STEROIDHORMON
STETHOSC	STETHOSCOPE
STEVEDOR	STEVEDOR
STEWARD	STEWARD
STICKST	STICKSTOFF
STILET	STILETTO
STILLB	STILLBIRTH
STIMUL	STIMULANT
STIMUL	STIMULAT
STITCH	STITCH
STITTSV	STITTSVILLE
STOCH	STOCHASTIC
STOCK	STOCK
STOCKBROK	STOCKBROKER
STOCKHOLD	STOCKHOLD
STOCKL	STOCKLIST
STOCKM	STOCKMAN
STOCKMARK	STOCKMARKET
STOCKT	STOCKTON
STOICHIOM	STOICHIOMETER
STOKHOLD	STOKHOLDING
STONEW	STONEWARE
STOPP	STOPPAGE
STORYB	STORYBOOK
STORYTELL	STORYTELL
STOUFFV	STOUFFVILLE
STOURBR	STOURBRIDGE
STRATF	STRATFORD
STRATIF	STRATIF
STRATIGR	STRATIGRAPHY
STRATOS	STRATOSPHER
STRAWB	STRAWBERRY
STR	STRET
STRETSV	STRETSVILLE
STRENGTH	STRENGTHENING
STRICT	STRICT
STROLL	STROLL
STRUCTRON	STRUCTRONICS
STRUCT	STRUCTURE
STRUGGL	STRUGGL
STUDB	STUDBOOK
STUDENTSH	STUDENTSHIP
STUD	STUDIES
STUD	STUDYING
STYL	STYLING
STYLIST	STYLIST
SUBALT	SUBALTERN
SUBAQUAT	SUBAQUATI
SUBARCT	SUBARCTIC
SUBAT	SUBATOMIC
SUBCELL	SUBCELLULAR
SUBCLIN	SUBCLINIC
SUBCOMM	SUBCOMMISSION
SUBCOMM	SUBCOMMITTEE
SUBCONT	SUBCONTINENT
SUBCONTRACT	SUBCONTRACT
SUBDIV	SUBDIVIS
SUBGR	SUBGROUP
SUBJ	SUBJECT
SUBMAR	SUBMARIN
SUBMERS	SUBMERSIBLE
SUBMICROSC	SUBMICROSCOP
SUBMISS	SUBMISSION
SUBMITT	SUBMITT
SUBNUCL	SUBNUCLEAR
SUBORD	SUBORDINATE
SUBPOPUL	SUBPOPULATION
SUBPROV	SUBPROVINC
SUBSCR	SUBSCRIB
SUBSCR	SUBSCRIPTION
SUBSECR	SUBSECRETAR
SUBSECT	SUBSECTION
SUBSEQ	SUBSEQUEN
SUBSER	SUBSERIES
SUBSIST	SUBSIST
SUBST	SUBSTANC
SUBST	SUBSTANT
SUBSTIT	SUBSTITUTE
SUBSTIT	SUBSTITUTION
SUBSTRUCT	SUBSTRUCTURE
SUBSURF	SUBSURFAC
SUBTERR	SUBTERRANEAN
SUBURB	SUBURBAN
SUBVENT	SUBVENTION
SUCCEED	SUCCEEDING
SUCCESS	SUCCESSFUL
SUCCESSOR	SUCCESSORAL
SUCCUL	SUCCULENT
SUDAN	SUDANESE
SUDAN	SUDANIC
SUDD	SUDDEN
SUFF	SUFFER
SUFFIC	SUFFICIENCY
SUGGEST	SUGGEST
SUITABIL	SUITABILITY
SUMER	SUMERIAN
SUMM	SUMMAR
SUMM	SUMMATIVE
SUMMERFALL	SUMMERFALLOW
SUMMERL	SUMMERLAND
SUNR	SUNRISE
SUNS	SUNSET
SUPERANN	SUPERANNUATION
SUPERCELL	SUPERCELLULAR
SUPERCERAM	SUPERCERAMIC
SUPERCOMPOS	SUPERCOMPOSIT
SUPERCOMPUT	SUPERCOMPUT
SUPERCOND	SUPERCONDUCT
SUPERCRIT	SUPERCRITICAL
SUPERF	SUPERFIC
SUPT	SUPERINTEND
SUPER	SUPERIOR
SUPERMARK	SUPERMARKET
SUPERNAT	SUPERNATURAL
SUPERPLAST	SUPERPLASTIC
SUPERST	SUPERSTORE
SUPERV	SUPERVISING
SUPERV	SUPERVISION
SUPERV	SUPERVISOR
SUPPL	SUPPLEMENT
SUPPLYSH	SUPPLYSHIP
SUPPR	SUPPRESSANT
SUPPR	SUPPRESSION
SUPRAMOL	SUPRAMOLECULAR
SUPRANATL	SUPRANATIONAL
SURF	SURFACE
SURF	SURFACING
SURG	SURGEON
SURG	SURGERY
SURG	SURGIC
SURN	SURNAME
SURPRIS	SURPRISING
SURREAL	SURREALIST
SURROG	SURROGAT
SURROUND	SURROUNDING
SURV	SURVEY
SURVIV	SURVIV
SUSQUEHAN	SUSQUEHANNA
SUSTAIN	SUSTAIN
SUTHERL	SUTHERLAND
SWANS	SWANSEA
SWAZIL	SWAZILAND
SWED	SWEDEN
SWED	SWEDISH
SWEEPST	SWEEPSTAKE
SWEETEN	SWEETEN
SWIM	SWIM
SWING	SWINGER
SWING	SWINGING
SWITCH	SWITCH
SWITCHB	SWITCHBOARD
SWITCHG	SWITCHGEAR
SWITZ	SWITZERLAND
SYD	SYDNEY
SYLVIC	SYLVICULT
SYMPH	SYMPHONY
SYNAG	SYNAGOGUE
SYNCHRON	SYNCHRONIZE
SYND	SYNDIC
SYNDROMOL	SYNDROMOLOGY
SYNERG	SYNERG
SYNON	SYNONYM
SYNOP	SYNOPSIS
SYST	SYSTEM
TABLEW	TABLEWARE
TABUL	TABULATION
TACK	TACKLE
TAIWAN	TAIWANESE
TAK	TAKING
TALENT	TALENT
TALK	TALKING
TALLAHASS	TALLAHASSEE
TANAIDAC	TANAIDAC
TANGAN	TANGANYKA
TANGL	TANGL
TANZAN	TANZANIA
TAPHON	TAPHONOMY
TARGET	TARGETED
TARGET	TARGETING
TARGUM	TARGUMIC
TARTOG	TARTOGENIC
TASMAN	TASMAN
TAST	TAST
TAX	TAXATION
TAX	TAXING
TAXPAY	TAXPAYER
TEACH	TEACHER
TEACH	TEACHING
TECHNOBIOL	TECHNOBIOLOGY
TECHNOCR	TECHNOCRACY
TECHNOCR	TECHNOCRAT
TECHNOG	TECHNOGEN
TECTONOPHYS	TECTONOPHYSI
TEDDINGT	TEDDINGTON
TELEB	TELEBOOK
TELECOMEUR	TELECOMEUROPA
TELECOMMUN	TELECOMMUNICATION
TELECOMMUT	TELECOMMUT
TELEGR	TELEGRAM
TELEMANAG	TELEMANAGEMENT
TELEM	TELEMETER
TELEPH	TELEPHON
TELEPR	TELEPRINTER
TELEPUBL	TELEPUBLISH
TELESC	TELESCOPE
TELEV	TELEVIS
TELEWORK	TELEWORKING
TEMPER	TEMPERANCE
TEMP	TEMPERAT
TEMPOR	TEMPORARY
TENN	TENNESSEE
TENS	TENSION
TERATOL	TERATOLOGY
TERMIN	TERMIN
TERMIT	TERMIT
TERR	TERRESTR
TERRIT	TERRIT
TERROR	TERROR
TERT	TERTIARY
TESTAM	TESTAMENT
TEST	TESTED
TESTIC	TESTICUL
TEST	TESTING
TETRAPEPT	TETRAPEPTIDES
TEX	TEXAS
TEXTB	TEXTBOOK
TEXT	TEXTIL
TEXT	TEXTILE
THAIL	THAILAND
THAMESV	THAMESVILLE
THEATR	THEATR
THEATRESCR	THEATRESCRIPT
THEMAT	THEMATIC
THEOL	THEOLOGY
THEOM	THEOMETRY
THEOR	THEORET
THEOR	THEORI
THER	THERAP
THERM	THERMAL
THERMION	THERMIONIC
THERMOCHEM	THERMOCHEM
THERMODYN	THERMODYNAMICS
THERMOELAST	THERMOELASTICITY
THERMOELECTR	THERMOELECTRI
THERMOGRAVIM	THERMOGRAVIMETER
THERMOLUMIN	THERMOLUMINESCENCE
THERMONUCL	THERMONUCLEAR
THERMOPHYS	THERMOPHYSICS
THERMOPLAST	THERMOPLASTIC
THERMOTHER	THERMOTHERAP
THESSALON	THESSALONIK
THICK	THICK
THINK	THINKER
THINK	THINKING
THIRTEEN	THIRTEENTH
THORAC	THORACAL
THORAC	THORACIC
THOR	THORONTO
THREAT	THREAT
THRESH	THRESH
THRESHOLD	THRESHOLD
THROMB	THROMBOTIC
THUMP	THUMP
THUNDERST	THUNDERSTORM
THURS	THURSDAY
THYROIDOL	THYROIDOLOGY
TIBETOL	TIBETOLOGY
TICK	TICKER
TICKET	TICKETING
TIMEKEEP	TIMEKEEPING
TIMESHAR	TIMESHAR
TINPL	TINPLATE
TITRIM	TITRIMETER
TOB	TOBACCO
TOB	TOBACCONIST
TOCOL	TOCOLOGY
TOILET	TOILET
TOLER	TOLERANCE
TOMOGR	TOMOGRAPHY
TONBR	TONBRIDGE
TOOL	TOOLING
TOOLMAK	TOOLMAKER
TOOLMAK	TOOLMAKING
TOP	TOPIC
TOPMAG	TOPMAGAZINE
TOPOL	TOPOLOGY
TOPON	TOPONYM
TORAC	TORACIC
TOR	TORONTO
TOTAL	TOTAL
TOUCHPAP	TOUCHPAPER
TOUR	TOURIS
TOWNCR	TOWNCRIER
TOWNSH	TOWNSHIP
TOWNSM	TOWNSMAN
TOWNSV	TOWNSVILLE
TOXIC	TOXICANT
TOXIC	TOXICITY
TOXICOKINET	TOXICOKINETI
TOXICOL	TOXICOLOGY
TRACK	TRACKING
TRACT	TRACTION
TRACT	TRACTOR
TRADEJ	TRADEJOURNAL
TRADELETT	TRADELETTER
TRADEN	TRADENAMES
TRAFFICK	TRAFFICK
TRAILBLAZ	TRAILBLAZ
TRAILER	TRAILERING
TRAILW	TRAILWAY
TRAINEESH	TRAINEESHIP
TRAIN	TRAINER
TRAIN	TRAINING
TRAMP	TRAMPING
TRAMW	TRAMWAY
TRANSATL	TRANSATLANTIC
TRANSBORD	TRANSBORDER
TRANSBOUND	TRANSBOUNDARY
TRANSCELL	TRANSCELLULAR
TRANSCEND	TRANSCENDENTAL
TRANSCR	TRANSCRIBER
TRANSCR	TRANSCRIPTION
TRANSCULT	TRANSCULTUR
TRANSDISCIPL	TRANSDISCIPLINE
TRANSDUCT	TRANSDUCTION
TRANSF	TRANSFER
TRANSFUS	TRANSFUSION
TRANSIT	TRANSITOIRE
TRANSKEI	TRANSKEIAN
TRANSL	TRANSLATION
TRANSLOCAT	TRANSLOCATION
TRANSM	TRANSMI
TRANSMUTAT	TRANSMUTATION
TRANSNATL	TRANSNATIONAL
TRANSPAR	TRANSPARENCY
TRANSPERS	TRANSPERSONAL
TRANSPL	TRANSPLANT
TRANSPLANT	TRANSPLANTATION
TRANSP	TRANSPORT
TRANSPUT	TRANSPUTER
TRANSW	TRANSWORLD
TRANSYLV	TRANSYLVANIAN
TRAPP	TRAPPER
TRAPP	TRAPPING
TRASM	TRASMISSION
TRAUMA	TRAUMATIC
TRAVEL	TRAVEL
TRAVELETT	TRAVELETTER
TRAWL	TRAWL
TREAS	TREASURER
TREAS	TREASURY
TREAT	TREATED
TREAT	TREATER
TREAT	TREATING
TREAT	TREATMENT
TRIATHL	TRIATHLETE
TRIBOL	TRIBOLOGY
TRICYCL	TRICYCLING
TRIENN	TRIENNIAL
TRIPART	TRIPARTIT
TRIQ	TRIQUARTERLY
TRIUMPH	TRIUMPH
TROGLOD	TROGLODYT
TROLLEYB	TROLLEYBUS
TROPHOBL	TROPHOBLAST
TROTSKY	TROTSKYIST
TRUCK	TRUCK
TRUST	TRUST
TRUSTEESH	TRUSTEESHIP
TUBER	TUBERCLE
TUBERCULOL	TUBERCULOLOGY
TUBERC	TUBERCULOS
TUBUL	TUBULAR
TUIT	TUITION
TUNIS	TUNISIA
TUNN	TUNNEL
TUNN	TUNNELLING
TURBID	TURBID
TURBOMACH	TURBOMACHINERY
TURBOTV	TURBOTVILLE
TURBUL	TURBULEN
TURCOL	TURCOLOGICAL
TURK	TURKEY
TURN	TURNER
TURN	TURNING
TURT	TURTLE
TUTOR	TUTORIAL
TWIST	TWIST
TYPEREAD	TYPEREADER
TYPESET	TYPESETTING
TYPEWRIT	TYPEWRITER
TYP	TYPICAL
TYPOGR	TYPOGRAPHY
TYPOL	TYPOLOGICAL
ULSTERM	ULSTERMAN
ULTIM	ULTIM
ULTRAFILTR	ULTRAFILTRATION
ULTRAH	ULTRAHIGH
ULTRAMOL	ULTRAMOLECULAR
ULTRANUTR	ULTRANUTRITION
ULTRAPRECIS	ULTRAPRECISION
ULTRAPURIF	ULTRAPURIFICATION
ULTRASTRUCT	ULTRASTRUCTURE
ULTRAV	ULTRAVIOLET
UMP	UMPIRE
UNCAPTIV	UNCAPTIV
UNCENS	UNCENSORED
UNCERTAIN	UNCERTAINTY
UNCLASSIF	UNCLASSIFI
UNCONV	UNCONVENTIONAL
UNCOOK	UNCOOKED
UNDERCURR	UNDERCURRENT
UNDEREMPL	UNDEREMPLOYED
UNDERGARM	UNDERGARMENT
UNDERGRAD	UNDERGRADUATE
UNDERGR	UNDERGROUND
UNDERST	UNDERSTANDING
UNDERT	UNDERTAKING
UNDERUTIL	UNDERUTILIS
UNDERW	UNDERWATER
UNDERWRIT	UNDERWRIT
UNEMPL	UNEMPLOY
UNEXAM	UNEXAMIN
UNFILL	UNFILL
UNIC	UNICORN
UNIF	UNIFORM
UNION	UNIONIST
UNISCI	UNISCIENCE
UNISHIPP	UNISHIPP
UNIT	UNITARIAN
UAR	UNITED ARAB REPUBLIC
UK	UNITED KINGDOM
UN	UNITED NATIONS
US	UNITED STATES
USA	UNITED STATES OF AMERICA
UNITHOLD	UNITHOLDER
UNIVERS	UNIVERSAL
UNIV	UNIVERSIT
UNKN	UNKNOWN
UNLTD	UNLIMITED
UNMASK	UNMASKING
UNMUZZ	UNMUZZLE
UNOFF	UNOFFICIAL
UNORGAN	UNORGANIC
UNPLUG	UNPLUG
UNPUBL	UNPUBLI
UNREACH	UNREACH
UNRELAT	UNRELATED
UNREPORT	UNREPORTED
UNREPRESENT	UNREPRESENTED
UNSCATH	UNSCATHED
UNSCHED	UNSCHEDUL
UNSPEAK	UNSPEAK
UNSUCCESS	UNSUCCESSFUL
UNTITL	UNTITL
UPCOM	UPCOMING
UPDAT	UPDATE
UPGRAD	UPGRAD
UPGRAD	UPGRADING
UPL	UPLAND
UP	UPPER
UPRAT	UPRATING
UPT	UPTOWN
UREM	UREM
URIN	URIN
URODYN	URODYNAMIC
UROGENIT	UROGENITAL
USEFUL	USEFUL
UTIL	UTILIZATION
VACANC	VACANCE
VACAT	VACATION
VACCINOL	VACCINOLOGY
VAC	VACUUM
VACUUMTECH	VACUUMTECHNICS
VAL	VALLEY
VALORIS	VALORISATION
VALUAB	VALUABLE
VALUAT	VALUATION
VANDAL	VANDALISM
VANGUARD	VANGUARD
VANISH	VANISHING
VAP	VAPOR
VAP	VAPOUR
VAR	VARIAB
VAR	VARIANCE
VAR	VARIANT
VAR	VARIATION
VAR	VARIET
VAR	VARIOUS
VARN	VARNISH
VASC	VASCUL
VASOACT	VASOACTIVE
VEG	VEGETA
VEH	VEHIC
VELOCIM	VELOCIMETER
VELV	VELOCIMETER
VEND	VENDING
VEND	VENDOR
VENER	VENEREAL
VENEREOL	VENEREOLOGY
VENOM	VENOMOUS
VENT	VENTILATION
VENTUR	VENTUR
VERBAT	VERBATIM
VERIF	VERIFYING
VT	VERMONT
VERNAC	VERNACULAR
VERT	VERTICAL
VESSEL	VESSEL
VESTIB	VESTIBULAR
VET	VETERINAR
VEXILLOL	VEXILLOLOGY
VIB	VIBRATION
VIBROTECH	VIBROTECHNICS
VICIN	VICINITY
VICKSBG	VICKSBURG
VICT	VICTIM
VICTIM	VICTIMIZATION
VIC	VICTORIA
VIC ISL	VICTORIA ISLAND
VIC	VICTORIAN
VIC	VICTORY
VICTUAL	VICTUALL
VIDEOGR	VIDEOGRAPHY
VIDEOSCOP	VIDEOSCOP
VIEWD	VIEWDATA
VIEWFIND	VIEWFINDER
VIEWP	VIEWPOINT
VIEWPR	VIEWPRINT
VIEWSWKL	VIEWSWEEKLY
VINCENT	VINCENTIAN
VINEG	VINEGAR
VINEMAK	VINEMAKING
VINIC	VINICULTUR
VIOL	VIOLATI
VIRG ISL	VIRGINISLANDS
VA	VIRGINIA
VISABIL	VISABILITY
VISC	VISCERAL
VIS	VISION
VISION	VISIONARY
VISIT	VISIT
VIS	VISUAL
VITAM	VITAMIN
VITIC	VITICULTUR
VITREORETIN	VITREORETIN
VIVER	VIVERRID
VIVISECT	VIVISECTION
VOCAB	VOCABULARY
VOCAT	VOCATION
VOLCAN	VOLCANIC
VOLCANOL	VOLCANOLOGY
VOLLEYB	VOLLEYBALL
VOLT	VOLTAGE
VOLUS	VOLUSIA
WAGEEARN	WAGEEARNER
WAIT	WAIT
WAIV	WAIV
WAKEF	WAKEFIELD
WALDENS	WALDENS
WALK	WALKER
WALK	WALKING
WALKW	WALKWAY
WALLCH	WALLCHART
WALLCOVER	WALLCOVERING
WALLPAP	WALLPAPER
WALLSTR	WALLSTRET
WALTH	WALTHAM
WALT	WALTON
WANDER	WANDER
WARB	WARBIRD
WARD	WARDEN
WAREH	WAREHOUSE
WAREHOUS	WAREHOUSING
WARF	WARFARE
WARG	WARGAME
WARMINST	WARMINSTER
WARN	WARN
WARSH	WARSHIP
WARWICKS	WARWICKSHIRE
WASH	WASHINGTON
WATCH	WATCH
WATCHB	WATCHBIRD
WATERF	WATERFORD
WATERFR	WATERFRONT
WATERW	WATERWAY
WAVEFUNCT	WAVEFUNCTION
WAVEL	WAVELENGTH
WEANL	WEANLING
WEAPON	WEAPONRY
WEATHER	WEATHER
WEAV	WEAV
WEDD	WEDD
WEEKBL	WEEKBLAD
WEEKEND	WEEKEND
WKLY	WEEKLY
WEIGH	WEIGHING
WEIGHT	WEIGHT
WEIGHTLIFT	WEIGHTLIFT
WELD	WELDER
WELD	WELDING
WELF	WELFARE
WELLINGB	WELLINGBOROUGH
WELLINGT	WELLINGTON
WESLEY	WESLEYAN
W VA	WEST VIRGINIA
WESTCHEST	WESTCHESTER
WEST	WESTERN
WESTMINST	WESTMINSTER
WESTMORL	WESTMORLAND
WESTMT	WESTMOUNT
WEST	WESTON
WEST SUPERMARE	WESTON SUPERMARE
WESTV	WESTVILLE
WESTW	WESTWARD
WETL	WETLAND
WEYBR	WEYBRIDGE
WHAL	WHALING
WHART	WHARTON
WHEATGROW	WHEATGROWER
WHEEL	WHEEL
WHISP	WHISPER
WHOLEN	WHOLENESS
WHOLES	WHOLESAL
WHOLIST	WHOLISTIC
WICKER	WICKER
WILDBIOL	WILDBIOLOGIE
WILDL	WILDLIFE
WILLIAMSBG	WILLIAMSBURG
WILL GROVE	WILLOW GROVE
WILTS	WILTSHIRE
WINCH	WINCHESTER
WIND	WIND
WINDF	WINDFALL
WINDL	WINDLETTER
WINDSURF	WINDSURF
WINEMAK	WINEMAK
WINER	WINER
WINESBG	WINESBURG
WIN	WINNER
WIN	WINNING
WINN	WINNIPEG
WINST	WINSTON
WINSTONSAL	WINSTONSALEM
WIREL	WIRELESS
WIS	WISCONSIN
WITCH	WITCH
WITHHOLD	WITHHOLD
WITN	WITNESS
WOLFKEEP	WOLFKEEP
WOLFV	WOLFVILLE
WOLVERH	WOLVERHAMPTON
WOLVER	WOLVERINE
WOODBROOK	WOODBROOKER
WOODCARV	WOODCARVER
WOODL	WOODLAND
WOODTURN	WOODTURNER
WOODWORK	WOODWORK
WOOLGROW	WOOLGROWER
WOOLHANDL	WOOLHANDLER
WOOL	WOOLLEN
WORCEST	WORCESTER
WORCS	WORCESTERSHIRE
WORK	WORK
WORKB	WORKBOOK
WORKGR	WORKGROUP
WORKH	WORKHOUSE
WORKLOAD	WORKLOAD
WORKM	WORKMAN
WORKP	WORKPAPER
WORKSETT	WORKSETTING
WORKSH	WORKSHEET
WORKSTN	WORKSTATION
WORLDTR	WORLDTRADE
WORLDW	WORLDWIDE
WORSH	WORSHIP
WORSHIPF	WORSHIPFUL
WORTHW	WORTHWHILE
WRAP	WRAPPING
WRECK	WRECK
WRESTL	WRESTL
WRIT	WRITER
WRIT	WRITING
WRIT	WRITTEN
WYO	WYOMING
XENOBIOCHEM	XENOBIOCHEMISTRY
XENOPHOB	XENOPHOBIA
XEROGR	XEROGRAPHY
YACHT	YACHTING
YACHTSM	YACHTSMAN
YANK	YANKEE
YEAR B	YEAR BOOK
YEARB	YEARBOOK
YEARL	YEARLING
YRLY	YEARLY
YEOM	YEOMAN
YESTERY	YESTERYEAR
YID	YIDISE
YODEL	YODEL
YONK	YONKER
YORKS	YORKSHIRE
YOURS	YOURSELF
YUGOSL	YUGOSLAV
ZAIR	ZAIR
ZAMB	ZAMBI
ZELLKULT	ZELLKULTUR
ZETET	ZETETIC
ZION	ZIONISM
ZION	ZIONIST
ABHOR	ABHOR
ABOLIT	ABOLITION
ABSOL	ABSOLUT
ACCENT	ACCENT
ACCESS	ACCESSIB
ACCUMUL	ACCUMULATION
ADJAC	ADJACENT
ADM	ADMINISTRATION
ADMIT	ADMITION
ADOPT	ADOPTION
ADRESS	ADRESS
ADRIAT	ADRIATIC
ADVOK	ADVOKAT
AERODYN	AERODYNAMIC
AEROL	AEROLOGY
AERONAUT	AERONAUTIC
AERON	AERONOM
AEROPHOTOGR	AEROPHOTOGRAPHY
AEROPT	AEROPORT
AEROTECH	AEROTECHNICS
AFT	AFTOS
AGIL	AGIL
AGRESSOL	AGRESSOLOGY
AGROBIOL	AGROBIOLOGY
AGROBOT	AGROBOTAN
AGROGEOL	AGROGEOLOGY
AGROL	AGROLOGY
AGROMELIOR	AGROMELIORA
AGRON	AGRONOM
AGROTECH	AGROTECHNICS
AKTUAL	AKTUAL
AKUT	AKUTAN
ALSK	ALASKA
ALCOVER	ALCOVER
ALEX	ALEXANDRIA
ALGEBR	ALGEBRA
ALGOL	ALGOLOGY
ALGORITM	ALGORITHM
ALIMENT	ALIMENT
ALLERGOL	ALLERGOLOGY
AMELIOR	AMELIORATION
AM	AMERIK
AMFIB	AMFIB
AMPELOL	AMPELOLOGY
AMPHIB	AMPHIBI
ANABAPT	ANABAPTIS
ANALG	ANALGES
ANALOG	ANALOGY
ANAMN	ANAMNES
ANAT	ANATOMI
ANGEIOL	ANGEIOLOGY
ANGIOL	ANGIOLOGY
ANGL	ANGLIA
ANNEX	ANNEX
ANORG	ANORGANI
ANTAGON	ANTAGONISM
ANTHOL	ANTHOLOGY
ANTHROPOL	ANTHROPOLOGY
ANTHROPOS	ANTHROPOSOPHISCH
ANTIANDROG	ANTIANDROGEN
ANTIBIOT	ANTIBIOTI
ANTICONCEPT	ANTICONCEPT
ANTIMETAB	ANTIMETABOLI
ANTIPARASIT	ANTIPARASIT
ANTITERMIT	ANTITERMIT
APHIDOL	APHIDOL
APPEND	APPENDI
AQUIS	AQUISI
ARAB	ARAB
ARACHNOL	ARACHNOLOGY
ARBITR	ARBITRA
ARCH	ARCHIV
ARGENT	ARGENTIN
ARG	ARGUS
AROMAT	AROMATIC
ARSEN	ARSENIC
ARTER	ARTERI
ARTIC	ARTICOLE
ARTIK	ARTIK
ARTIST	ARTIST
ASCENS	ASCENS
ASCET	ASCETI
ASPH	ASPHALT
ASPIR	ASPIRANT
ASSIST	ASSIST
ASTROBOT	ASTROBOTAN
ASTROL	ASTROLOGY
ASTRONAUT	ASTRONAUT
ASTRON	ASTRONOM
ASTROPHYS	ASTROPHYSICSS
ATOMAPSORBT	ATOMAPSORBTION
AT	ATOMI
AT	ATOMO
ATTRIB	ATTRIBUTION
AUDIOL	AUDIOLOGY
AUGMENT	AUGMENT
AUST	AUSTRALI
AUTOM	AUTOMATIC
AUTON	AUTONOMOUS
AUTORADIOGR	AUTORADIOGRAPHY
AUT	AUTORIS
AUTOTRANSP	AUTOTRANSP
AUXOL	AUXOLOGY
AVIC	AVICULT
AZUR	AZUR
AMBETSMANNAKOMM	AMBETSMANNAKOMMITTEN
BALANC	BALANCE
BALLOT	BALLOT
BALT	BALTI
BANGK	BANGKOK
BAROM	BAROMETER
BENEDICT	BENEDICT
BIBLIOGR	BIBLIOGRAPHY
BIFURC	BIFURCATION
BIOCHRONOM	BIOCHRONOMETER
BIOCOORD	BIOCOORDINAT
BIOENERG	BIOENERGETICS
BIOEPISTEMOL	BIOEPISTEMOLOGY
BIOG	BIOGENENETICS
BIOGEOGR	BIOGEOGRAPHY
BIOGR	BIOGRAPHY
BIOL	BIOLOGY
BIOMATER	BIOMATERIAL
BIOMATH	BIOMATHEMAT
BIOMECH	BIOMECHANICS
BIOMETEOROL	BIOMETEOROLOGY
BIOM	BIOMETRICS
BIOMINER	BIOMINERAL
BIOPHYS	BIOPHYSICS
BIOPOLYM	BIOPOLYMER
BIORHEOL	BIORHEOLOGY
BIOTECH	BIOTECHNICS
BIOTECHNOL	BIOTECHNOLOGY
BIOTHEOR	BIOTHEORETI
BIZN	BIZNIS
BOLIV	BOLIV
BOT	BOTAN
BREV	BREVET
BROMATOL	BROMATOLOGY
BRONCHOESOPHAGOL	BRONCHOESOPHAGOLOGY
BRUCELL	BRUCELLOS
BRYOL	BRYOLOGY
BRYOPHYT	BRYOPHYT
BULIM	BULIMIA
BULL	BULLETIN
CALABR	CALABR
CALOR	CALORIE
CALVIN	CALVINIST
CARAVAN	CARAVAN
CARSK	CARSK
CATARACT	CATARACT
CAVALC	CAVALCADE
CELT	CELTI
CENT	CENTRAL
CENT	CENTRUM
CHANG	CHANGE
CHARG	CHARGE
CHARISM	CHARISM
CHARIT	CHARITAB
CHOLEST	CHOLESTEROL
CHORAL	CHORAL
CHRIST	CHRISTIAN
CHROMOSOM	CHROMOSOM
CHRONOBIOL	CHRONOBIOLOGY
CHRONOL	CHRONOLOGY
CIGAR	CIGARETTE
CIRC	CIRCUL
CLAR	CLARINET
CODIF	CODIFICATION
COGN	COGNIT
COLOPROCTOL	COLOPROCTOLOGIA
COLOR	COLOR
COMED	COMED
COMEST	COMESTIBLE
COMMAND	COMMAND
CONCERT	CONCERT
CONCURR	CONCURRENT
CONDUCT	CONDUCT
CONFIN	CONFIN
CONGEST	CONGEST
CONNECT	CONNECT
CONSENS	CONSENSUS
CONSERV	CONSERVATION
CONSOLAT	CONSOLATION
CONTEXT	CONTEXT
CONTRADICT	CONTRADICTION
CONV	CONVEN
CONVOC	CONVOCA
CONVULS	CONVULS
COORD	COORDINATION
COSM	COSMIC
COSMONAUT	COSMONAUT
COSMOP	COSMOPOLITAN
CREAT	CREAT
CREDIT	CREDIT
CROCH	CROCHET
CRUCIF	CRUCIF
CRUSTAC	CRUSTAC
CYNOS	CYNOSURE
DACOROM	DACOROMAN
DANUB	DANUB
DECOD	DECODIFICATION
DEFORM	DEFORMATION
DELECT	DELECT
DELEG	DELEGATION
DELPHIN	DELPHINIUM
DEMOGR	DEMOGRAPHY
DEMONSTR	DEMONSTRATION
DENDROL	DENDROLOGY
DENTROL	DENTROLOGY
DEONTOL	DEONTOLOGY
DEPORT	DEPORT
DEPUT	DEPUTAT
DERM	DERMATO
DERMATOL	DERMATOLOGY
DERMATOVENEROL	DERMATOVENEROLOGY
DERMOSIFILIOGR	DERMOSIFILIOGRAF
DESINTOX	DESINTOXICATION
DIABETOL	DIABETOLOGY
DIAGN	DIAGNOSTICS
DIALEKT	DIALEKTI
DIALEKTOL	DIALEKTOLOGY
DIAL	DIALYS
DIDASK	DIDASKAL
DIET	DIETET
DIETOL	DIETOLOGY
DIGIT	DIGITAL
DIPL	DIPLOMAT
DISCRIM	DISCRIMINATION
DISPERS	DISPERSION
DISPOS	DISPOSABLE
DISPUT	DISPUT
DOSIM	DOSIMETER
DROFORSK	DROFORSKN
DROGFORSK	DROGFORSKN
DROG	DROGUER
DUODEN	DUODEN
DUPLIC	DUPLICAT
DYNAST	DYNASTI
ECONOM	ECONOMETERI
EKOL	EKOLOGY
EKON	EKONOM
ELABOR	ELABOR
ELASTOPLAST	ELASTOPLASTI
ELECTROFISIOL	ELECTROFISIOLOGY
ELETROIMMUNOCHEM	ELECTROIMMUNOCHEMISTRY
ELEMENTOORG	ELEMENTOORGANI
EMBRYOL	EMBRYOLOGY
EMIGR	EMIGR
EMULS	EMULS
ENCOURAG	ENCOURAGEMENT
ENDEM	ENDEMI
ENDOG	ENDOGEN
ENDOTHEL	ENDOTHEL
ENDOUROL	ENDOUROLOGY
ENDUR	ENDUR
ENERG	ENERGETICS
ENERGISTAT	ENERGISTATISTIK
ENTEROL	ENTEROLOGY
ENTOMOL	ENTOMOLOGY
ENVEL	ENVELOP
ENZYMOL	ENZYMOLOGY
EPIDEMIOL	EPIDEMIOLOGY
EPIGR	EPIGRAPHY
EPILEPTOL	EPILEPTOLOGY
EPIPHYT	EPIPHYTI
EPIZOOT	EPIZOOTI
EPIZOOTOL	EPIZOOTOLOGY
EROT	EROTIKA
ERYTHROP	ERYTHROPOIET
ESLASTOM	ESLASTOM
ESOPHAGOL	ESOPHAGOLOGY
ESOTER	ESOTERI
ESPAC	ESPAC
ESTER	ESTERIOR
ESTHET	ESTHETI
ETHNOGR	ETHNOGRAPHY
ETHNOL	ETHNOLOGY
ETHNOMUSICOL	ETHNOMUSICOLOGY
ETHOPHARMACOL	ETHOPHARMACOLOGY
ETIOL	ETIOLOGY
EUR	EUROPE
EUROREG	EUROREGION
EUROSTAND	EUROSTANDARD
EUROSTAT	EUROSTAT
EUROVIS	EUROVISION
EUTHAN	EUTHANAS
EXCEPT	EXCEPTION
EXCIP	EXCIPIENT
EXCLUS	EXCLUSIVE
EX	EXEMPLE
EXIG	EXIG
EXIST	EXIST
EXPANS	EXPANSION
EXPATR	EXPATR
EXPECT	EXPECTA
EXPERT	EXPERT
FAK	FAKULT
FANTAST	FANTAST
FATAL	FATAL
FEM	FEMIN
FENOM	FENOMEN
FILAT	FILATELI
FILMOGR	FILMOGR
FILMOL	FILMOLOGIC
FILOS	FILOSOF
FLAGR	FLAGRANT
FLEX	FLEXIBLE
FLUVIOM	FLUVIOMETER
FORMUL	FORMULAR
FORMUL	FORMULATION
FORTIF	FORTIFICATION
FOSS	FOSSIL
FOTOGR	FOTOGRAPHY
FOTOINTERPRET	FOTOINTERPRET
FRUCT	FRUCT
GALACT	GALACTIC
GALEN	GALENI
GALL	GALLIA
GALVANOTECH	GALVANOTECHNICS
GAMB	GAMBI
GASTROENTEROL	GASTROENTEROLOGY
GEMELLOL	GEMELLOLOGY
GEMMOL	GEMMOLOGY
GENAGOG	GENAGOGUE
GENEAL	GENEALOGY
GENER	GENERATION
GENES	GENESIS
GENES	GENESUNG
GENET	GENET
GEOBOT	GEOBOTAN
GEOD	GEODES
GEOD	GEODET
GEOIND	GEOINDUSTRIA
GEOL	GEOLOGY
GEOMAGN	GEOMAGNETIC
GEOMATH	GEOMATHEMATIC
GEOMECH	GEOMECHANI
GEOM	GEOMETER
GEOSCI	GEOSCIENCE
GEOSPH	GEOSPHAERA
GEOSTAT	GEOSTATISTICS
GEOTECH	GEOTECHNICS
GERIATR	GERIATRI
GERONTOL	GERONTOLOGY
GLOB	GLOBAL
GLORIF	GLORIF
GNATHOL	GNATHOLOGY
GNOTOBIOL	GNOTOBIOLOGY
GRAF	GRAFI
GRAPHOL	GRAPHOLOGY
GRAV	GRAVEUR
GRAVIM	GRAVIMETER
GUIN BISSAU	GUINEA BISSAU
GUITAR	GUITAR
HABILIT	HABILITAT
HANDELSSTAT	HANDELSSTATISTI
HEBR	HEBRAIC
HEMATOL	HEMATOLOGY
HEMOPH	HEMOPHIL
HEPATOL	HEPATOLOGY
HEPATOSPLENOL	HEPATOSPLENOLOGY
HERBIV	HERBIVOR
HERPETOL	HERPETOLOGY
HETEROG	HETEROGEN
HEXACHORD	HEXACHORD
HIPERTENS	HIPERTENS
HISTOL	HISTOLOGY
HISTOPHYSIOL	HISTOPHYSIOLOGY
HOLOGR	HOLOGRAPHY
HOMEOPAT	HOMEOPAT
HONOL	HONOLULU
HONOR	HONOR
HORM	HORMON
HORMONOL	HORMONOLOGY
HOROL	HOROLOGY
HOSTEL	HOSTEL
HUSSERL	HUSSERL
HYDRAUL	HYDRAULIC
HYDROBIOL	HYDROBIOLOGY
HYDRODYN	HYDRODYNAMICS
HYDROGEOL	HYDROGEOLOGY
HYDROGR	HYDROGRAPHY
HYDROL	HYDROLOGY
HYPERACT	HYPERACT
HYPERB	HYPERBAR
HYPOTHAL	HYPOTHALAM
ICHTHYOL	ICHTHYOLOGY
ICTIOL	ICTIOLOGY
IDEFEM	IDEFEMINA
IKOR	IKORODU
ILLICIT	ILLICIT
ILLUSION	ILLUSION
IMMACUL	IMMACUL
IMMED	IMMEDIATE
IMMORTAL	IMMORTAL
IMP	IMPERIA
IMPLANTOL	IMPLANTOLOGY
IMPREGN	IMPREGNATION
INALIEN	INALIENABLE
INCEND	INCENDI
INDEMN	INDEMNIT
INDIVID	INDIVID
INDOEUR	INDOEUROP
IND	INDUSTRY
INFIN	INFINIT
INFOBULL	INFOBULLETIN
INF	INFORMATION
INFRACT	INFRACTION
INFUS	INFUSION
INHIB	INHIBIT
INNOV	INNOVATION
INOX	INOX
INSER	INSER
INST	INSTITUT
INST	INSTITUTION
INTELEKT	INTELEKTUAL
INTELL	INTELLIGENT
INTERCHANG	INTERCHANGE
INTERLING	INTERLINGUA
INTERN	INTERNAT
INTERPANOR	INTERPANORAMA
INTERPRET	INTERPRET
INTERSECT	INTERSECTION
INTERV	INTERVEN
INVESTIG	INVESTIGA
ION	IONIC
IRAN	IRANI
ISLAM	ISLAM
ISOT	ISOTOP
ISR	ISRAEL
IZOL	IZOLANT
JARG	JARGON
JEDIN	JEDIN
JESUIT	JESUIT
JUBIL	JUBIL
J	JURNAL
KALAH	KALAHARI
KALEIDOSC	KALEIDOSCOPE
KAMPUCH	KAMPUCHEA
KINEMATOGR	KINEMATOGR
KOMBAT	KOMBATANT
KOMUNIST	KOMUNIST
KOSMONAUT	KOSMONAUT
KOS	KOSOV
KREAT	KREAT
KURAT	KURAT
KURD	KURDISTAN
LAB	LABORATOR
LARYNGOL	LARYNGOLOGY
LECT	LECTOR
LEGUM	LEGUM
LENINGR	LENINGRAD
LENIN	LENINIST
LEPROL	LEPROLOGY
LEUK	LEUKEMI
LICHENOL	LICHENOLOGY
LICIT	LICITATION
LIMNOL	LIMNOLOGY
LINGUIST	LINGUIST
LIT	LITERAT
LITHOGR	LITHOGRAPHY
LITHOL	LITHOLOGY
LITH	LITHUANI
LITOL	LITOLOGY
LOCALIS	LOCALISATION
LOCOMOT	LOCOMOTI
LOGOP	LOGOPED
LYMPH	LYMPHOCYTE
MACED	MACEDONI
MACROPERSPECT	MACROPERSPECTIVE
MADAG	MADAGASCAR
MAGMAT	MAGMATI
MAGNES	MAGNESIUM
MAGN	MAGNETI
MAGNETOHYDRODYN	MAGNETOHYDRODYNAMI
MAGNETOPLASMADYN	MAGNETOPLASMADYNAMI
MAKET	MAKET
MALARIOL	MALARIOLOGY
MANAGE	MANAGEMENT
MANAG	MANAGEMENT
MARX	MARX
MATERN	MATERN
MEDICAM	MEDICAMENT
MEDIT	MEDITATION
MEK	MEKANI
MELANES	MELANES
MERCAT	MERCAT
MERCEN	MERCENA
MERID	MERIDIONAL
MESOLITH	MESOLITH
MESSAG	MESSAG
MESSIN	MESSIN
METAB	METABOLI
METABOL	METABOLOGY
MET	METAL
METALLOG	METALLOGEN
METALL	METALLURGY
METEOROL	METEOROLOGY
METROL	METROLOGY
METROP	METROPOLITAN
MICROECOL	MICROECOLOGY
MICROFICH	MICROFICH
MICROFILM	MICROFILM
MIGR	MIGRATOR
MILLES	MILLESIME
MIMEOGR	MIMEOGRAPHY
MINER	MINERAL
MINERAL	MINERALOGY
MINIST	MINISTR
MINOR	MINOR
MISSION	MISSION
MITROP	MITROPOL
MOB	MOBILO
MODIF	MODIFICATION
MONARCH	MONARCH
MONET	MONET
MONOLITH	MONOLITH
MONOLOG	MONOLOGUE
MONOP	MONOPOL
MONTEN	MONTENEGRO
MORB	MORBID
MOTIV	MOTIV
MULTICULT	MULTICULTUR
MULTIDIMENS	MULTIDIMENSION
MULTIETHN	MULTIETHNIC
MULTIETN	MULTIETN
MULTIMED	MULTIMEDIA
MULTIPR	MULTIPRINT
MUSEOL	MUSEOLOGY
MUSET	MUSETTE
MYOCARD	MYOCARDIUM
MYOGR	MYOGRAPHY
MYOL	MYOLOGY
MYTH	MYTH
MYXOMYC	MYXOMYCET
NAC	NACION
NARK	NARKOT
NAVIG	NAVIGA
NECROL	NECROLOGY
NEMATOL	NEMATOLOGY
NEOHELL	NEOHELLENI
NEOLIT	NEOLIT
NEOTESTAM	NEOTESTAMENT
NEOZEL	NEOZELANDESA
NERV	NERVOSA
NEUROANAT	NEUROANATOM
NEUROBIOL	NEUROBIOLOGY
NEUROENDOCR	NEUROENDOCRIN
NEUROGERONTOL	NEUROGERONTOLOGY
NEUROLEPTANALG	NEUROLEPTANALGES
NEUROL	NEUROLOGY
NEUROMETAB	NEUROMETABOLI
NEUROONTOG	NEUROONTOGEN
NEUROPATHOL	NEUROPATHOLOGY
NEUROPHYSIOL	NEUROPHYSIOLOGY
NEUROPSYCHIATR	NEUROPSYCHIATRI
NEUROPSYCHOL	NEUROPSYCHOLOGY
NEUROVEG	NEUROVEGETATIV
NIHIL	NIHIL
NIPIOL	NIPIOLOGY
NIPPON	NIPPON
NOCT	NOCTURN
NONVIOL	NONVIOLENT
NORD	NORD
NORM	NORMAL
NOSTALG	NOSTALG
NOT	NOTATION
NOVEMB	NOVEMBER
NUKL	NUKLEUS
NUMIS	NUMISMATI
NUTR	NUTRI
OBJECT	OBJECTIVE
OBS	OBSERVATION
OBSTET	OBSTETRI
OCEAN	OCEAN
ODAL	ODALISQUE
ODBOR	ODBOR
ODONTOIATR	ODONTOIATRI
ODONTOL	ODONTOLOGY
ODONTOSTOMATOL	ODONTOSTOMATOLOGY
OFF	OFFICIAL
OFTALMOL	OFTALMOLOGY
OLISIP	OLISIP
ONOMAST	ONOMAST
ONTOG	ONTOGEN
OPER	OPERAT
OPTIM	OPTIMUM
OPTOM	OPTOMETER
ORCHID	ORCHID
ORGAN	ORGANIZA
ORGANOL	ORGANOLOGI
ORTHODOX	ORTHODOX
ORTHOGNATH	ORTHOGNATH
OSCIL	OSCILATION
OSTEOARTIC	OSTEOARTICUL
OTOLARYNGOL	OTOLARYNGOLOGY
OTOL	OTOLOGY
OTOOPHTHALMOL	OTOOPHTHALMOLOGY
OTORHINOLARYNGOL	OTORHINOLARYNGOLOGY
PACIF	PACIFIST
PALEODONT	PALEODONT
PALEONTOGR	PALEONTOGRAPHY
PALEONTOL	PALEONTOLOGY
PALEOTECTON	PALEOTECTONIC
PALEST	PALESTIN
PALMYR	PALMYR
PALUD	PALUDISM
PALYNOL	PALYNOLOGY
PAMIAT	PAMIAT
PANOR	PANORAMA
PANTOGR	PANTOGRAPHY
PAPIRFOREDL	PAPIRFOREDLING
PARABOL	PARABOL
PARACHUT	PARACHUT
PARALIS	PARALIS
PARAMAGN	PARAMAGN
PARAMED	PARAMEDIC
PARAMETR	PARAMETER
PARANORM	PARANORMAL
PARAPSYCHOL	PARAPSYCHOLOGY
PARAPSYKOL	PARAPSYKOL
PARIT	PARIT
PARNAS	PARNAS
PARODONTOL	PARODONTOLOGY
PARTICIP	PARTICIPATION
PATAPHYS	PATAPHYSICSA
PATHOBIOL	PATHOBIOLOGY
PATHOG	PATHOGEN
PATHOL	PATHOLOGY
PEDAGOG	PEDAGOG
PEDIATR	PEDIATRI
PEDOL	PEDOLOGY
PENDUL	PENDUL
PEPT	PEPTID
PERCUSS	PERCUSS
PERFUS	PERFUS
PERINATOL	PERINATOLOGY
PERIOD	PERIODI
PERIODONTOL	PERIODONTOLOGY
PERMAC	PERMACULTURE
PERS	PERSON
PERSPECT	PERSPECTIV
PETROL	PETROLOGY
PHARMACODYN	PHARMACODYNAM
PHENOMENOL	PHENOMENOLOGY
PHILANTHR	PHILANTHROP
PHILHARM	PHILHARMONI
PHILOMATH	PHILOMATHI
PHILOS	PHILOSOPH
PHLEBOL	PHLEBOLOGY
PHONIATR	PHONIATRI
PHONOL	PHONOLOGY
PHOTOBIOL	PHOTOBIOLOGY
PHOTOCOP	PHOTOCOP
PHOTOGRAMM	PHOTOGRAMMETER
PHOTOGR	PHOTOGRAPHY
PHOTOJ	PHOTOJOURNAL
PHOTOM	PHOTOMETER
PHOTOPHYSIOL	PHOTOPHYSIOLOGY
PHOTOREACT	PHOTOREACTION
PHYSIATR	PHYSIATRI
PHYS	PHYSICSH
PHYSIOGN	PHYSIOGN
PHYSIOGR	PHYSIOGRAPHY
PHYSIOL	PHYSIOLOGY
PHYSIOPATHOL	PHYSIOPATHOLOGY
PHYSIOTHER	PHYSIOTHERAP
PHYTIATR	PHYTIATR
PHYTOCHEM	PHYTOCHEM
PHYTOCOEN	PHYTOCOENOSIS
PHYTOGENET	PHYTOGENET
PHYTOGEOGR	PHYTOGEOGRAPHY
PHYTOL	PHYTOLOGY
PHYTOPARASIT	PHYTOPARASIT
PHYTOPATHOL	PHYTOPATHOLOGY
PHYTOTAXON	PHYTOTAXONOM
PHYTOTHER	PHYTOTHERAP
PIGMENT	PIGMENT
PILOT	PILOT
PINT	PINTA
PLAKAT	PLAKAT
PLANIF	PLANIF
PLAST	PLASTI
PLEX	PLEXUS
PLUR	PLURAL
PNEUM	PNEUMATI
PNEUMOL	PNEUMOLOGY
PNEUMONOL	PNEUMONOLOGY
PODOL	PODOL
POET	POET
POLAROGR	POLAROGRAPHY
POL	POLEN
POLIT	POLITI
POLYCONDENS	POLYCONDENSAT
POLYSACCH	POLYSACCHARIDE
PONTIF	PONTIFI
POP	POPULAR
PORNOGR	PORNOGRAPHY
POSTMAGMAT	POSTMAGMATI
PRAKT	PRAKT
PRAXIM	PRAXIMETER
PREFABR	PREFABRIC
PREF	PREFACE
PRESS	PRESSION
PRESTIG	PRESTIGE
PRIMATOL	PRIMATOLOGY
PRIRODOSL	PRIRODOSLOVN
PROBL	PROBLEM
PROFR	PROFESSOR
PROFITAB	PROFITABLE
PROGN	PROGNOS
PROIZV	PROIZVOD
PROKUR	PROKUR
PROPHYL	PROPHYLAX
PROTEST	PROTESTATION
PROTISTOL	PROTISTOLOGY
PROTOZOOL	PROTOZOOLOGY
PROVID	PROVID
PROVOCAT	PROVOCAT
PROX	PROXIM
PSEUD	PSEUDONYM
PSICOPEDAG	PSICOPEDAG
PSYCHIATR	PSYCHIATRI
PSYCHOBIOL	PSYCHOBIOLOGY
PSYCHOL	PSYCHOLOGY
PSYCHOM	PSYCHOMETER
PSYCHONEUROL	PSYCHONEUROLOGY
PSYCHON	PSYCHONOM
PSYCHOSOM	PSYCHOSOMAT
PSYCHOTECH	PSYCHOTECHNICS
PSYCHOTER	PSYCHOTERAP
PSYCHOTHER	PSYCHOTHERAP
PSYCHOTR	PSYCHOTROP
PYROM	PYROMETER
QUANT	QUANTIT
RADIOAMAT	RADIOAMAT
RADIOANAL	RADIOANALY
RADIOASTRON	RADIOASTRONOM
RADIOBIOL	RADIOBIOLOGY
RADIOCOMMUN	RADIOCOMMUNIC
RADIOELEM	RADIOELEMENT
RADIOGEOL	RADIOGEOLOGY
RADIOGR	RADIOGRAPHY
RADIOIND	RADIOINDUSTRI
RADIOISOT	RADIOISOTOP
RADIOLAB	RADIOLABORAT
RADIOL	RADIOLOGY
RADIOM	RADIOMETER
RADIOPHYSIOL	RADIOPHYSIOLOGY
RADIOTELEM	RADIOTELEMETER
RADIOTELEV	RADIOTELEV
RADIOTHER	RADIOTHERAP
RAMIF	RAMIFICATION
RAPHAEL	RAPHAELITE
RAZVED	RAZVEDEN
RAZVIT	RAZVIT
REALIZ	REALIZATION
REANIMATOL	REANIMATOLOGY
REF	REFERENC
REFUS	REFUS
REG	REGIO
REG	REGION
REGIST	REGIST
REGULAM	REGULAMENT
REHABIL	REHABILITAT
RELEV	RELEV
RENAISS	RENAISSANCE
REND	RENDEMENT
REPLACE	REPLACE
REPTIL	REPTIL
REPUB	REPUBLIK
RESERV	RESERV
RESID	RESIDENC
RESPONSAB	RESPONSABLE
RESTAUR	RESTAURANT
RETARD	RETARD
RETROVIR	RETROVIRUS
REVENDIC	REVENDICATION
RHAPS	RHAPSOD
RHENAN	RHENAN
RHEOL	RHEOLOGY
RHEUM	RHEUMATI
RHEUMATOL	RHEUMATOLOGY
RHINOL	RHINOLOGY
RISAL	RISALAH
ROMAN	ROMANCE
ROSENTHAL	ROSENTHALIAN
ROTISS	ROTISSERIE
RUMIN	RUMINANT
RURAL	RURAL
SACCH	SACCHARIDE
SACRIF	SACRIFIC
SAMMENSLUT	SAMMENSLUTNING
SAN FRANC	SAN FRANCISCO
ST	SANCTUS
SATISF	SATISF
SCAND	SCANDIC
SCHIZOPHR	SCHIZOPHREN
SEDIMENTOL	SEDIMENTOLOGY
SEGM	SEGMENT
SEISM	SEISM
SEKT	SEKTOR
SEMIN	SEMINAR
SEMIOT	SEMIOTI
SEN	SENILE
SENOL	SENOLOGY
SENSIB	SENSIBIL
SENSIB	SENSIBLE
SEPTENTR	SEPTENTRIONAL
SEQ	SEQUEN
SER	SERIE
SERIOL	SERIOLOGY
SEROL	SEROLOGY
SEROTAXON	SEROTAXONOM
SEXOL	SEXOLOGY
SIDER	SIDERURGI
SIFILIOGR	SIFILIOGRAF
SIFILOGR	SIFILOGRAPHY
SILENT	SILENT
SINGUL	SINGUL
SINOL	SINOLOGY
SK	SKOL
SLOVAK	SLOVAKIST
SOCIOCULT	SOCIOCULTUR
SON	SONOR
SOPHISTIC	SOPHISTIC
SOV	SOVIET
SPECUL	SPECULATION
SPELEOL	SPELEOLOGY
SPERMATOL	SPERMATOLOGY
SPLENOL	SPLENOLOGY
SQ	SQUARE
STALIN	STALINISM
STAT	STATIST
STEREOL	STEREOLOGY
STEREOPH	STEREOPHON
STIPEND	STIPEND
STIPUL	STIPULATION
STOMATOL	STOMATOLOGY
STRATEG	STRATEGY
STRESS	STRESS
STUD	STUDENT
SUBALP	SUBALPIN
SUBMERG	SUBMERG
SUBNORM	SUBNORMAL
SUBSID	SUBSID
SUBSTR	SUBSTRAT
SUBTROP	SUBTROP
SUBVERS	SUBVERS
SUICIDOL	SUICIDOLOGY
SUPPORT	SUPPORT
SURPL	SURPLUS
SUSPENS	SUSPENS
SYMB	SYMBOL
SYMP	SYMPOSIUM
SYMP	SYMPOZ
SYNAP	SYNAPSE
SYNDR	SYNDROM
SYNOP	SYNOPT
SYNTH	SYNTHESIS
SYNTH	SYNTHET
SYPHILIGR	SYPHILIGRAPHY
SYPH	SYPHILIS
SYPH	SYPHILITI
SYPHILOL	SYPHILOLOGY
SYR	SYRI
SACCH	SACCHARIDE
SACRIF	SACRIFIC
SAMMENSLUT	SAMMENSLUTNING
SAN FRANC	SAN FRANCISCO
ST	SANCTUS
SATISF	SATISF
SCAND	SCANDIC
SCHIZOPHR	SCHIZOPHREN
SEDIMENTOL	SEDIMENTOLOGY
SEGM	SEGMENT
SEISM	SEISM
SEKT	SEKTOR
SEMIN	SEMINAR
SEMIOT	SEMIOTI
SEN	SENILE
SENOL	SENOLOGY
SENSIB	SENSIBIL
SENSIB	SENSIBLE
SEPTENTR	SEPTENTRIONAL
SEQ	SEQUEN
SER	SERIE
SERIOL	SERIOLOGY
SEROL	SEROLOGY
SEROTAXON	SEROTAXONOM
SEXOL	SEXOLOGY
SIDER	SIDERURGI
SIFILIOGR	SIFILIOGRAF
SIFILOGR	SIFILOGRAPHY
SILENT	SILENT
SINGUL	SINGUL
SINOL	SINOLOGY
SK	SKOL
SLOVAK	SLOVAKIST
SOCIOCULT	SOCIOCULTUR
SON	SONOR
SOPHISTIC	SOPHISTIC
SOV	SOVIET
SPECUL	SPECULATION
SPELEOL	SPELEOLOGY
SPERMATOL	SPERMATOLOGY
SPLENOL	SPLENOLOGY
SQ	SQUARE
STALIN	STALINISM
STAT	STATISTICS
STEREOL	STEREOLOGY
STEREOPH	STEREOPHON
STIPEND	STIPEND
STIPUL	STIPULATION
STOMATOL	STOMATOLOGY
STRATEG	STRATEGY
STRESS	STRESS
STUD	STUDENT
SUBALP	SUBALPIN
SUBMERG	SUBMERG
SUBNORM	SUBNORM
SUBSID	SUBSID
SUBSTR	SUBSTRAT
SUBTROP	SUBTROP
SUBVERS	SUBVERS
SUICIDOL	SUICIDOLOGY
SUPPORT	SUPPORT
SURPL	SURPLUS
SUSPENS	SUSPENS
SYMB	SYMBOL
SYMP	SYMPOSIUM
SYMP	SYMPOZ
SYNAP	SYNAPSE
SYNDR	SYNDROM
SYNOP	SYNOPT
SYNTH	SYNTHES
SYNTH	SYNTHET
SYPHILIGR	SYPHILIGRAPHY
SYPH	SYPHILIS
SYPH	SYPHILITI
SYPHILOL	SYPHILOLOGY
SYR	SYRI
TARIF	TARIF
TAXON	TAXONOM
TEATR	TEATR
TECH	TECHNIC
TECHNOL	TECHNOLOGY
TEK	TEKNIK
TELEF	TELEFON
TELEGR	TELEGRAPHY
TELEMECH	TELEMECHANI
TELESYMP	TELESYMPOS
TEOR	THEORY
TERMAL	TERMAL
TERMINOL	TERMINOLOGY
TERMOIDRAUL	TERMOIDRAULIC
THALASS	THALASS
THANATOL	THANATOLOGY
THEK	THEKNOS
THERIOL	THERIOLOGY
THERMOBIOL	THERMOBIOLOGY
THERMOGR	THERMOGRAPHY
THERMOL	THERMOLOGY
THERMOM	THERMOMETER
THERMOREGUL	THERMOREGULAT
THROMB	THROMBOS
THYROID	THYROID
TIBET	TIBET
TOPOGR	TOPOGRAPHY
TOPOM	TOPOMETER
TOUR	TOURING
TOXICOM	TOXICOM
TRACH	TRACHOM
TRADIT	TRADITION
TRANS	TRANSACTION
TRANSFORM	TRANSFORMATION
TRANSFRONT	TRANSFRONT
TRASPL	TRASPLANT
TRAUMATOL	TRAUMATOLOGY
TRIBUL	TRIBULATION
TRICOLOR	TRICOLOR
TRILING	TRILINGU
TRISACCH	TRISACCHARIDE
TROMB	TROMBONE
TROMPET	TROMPET
TROP	TROPI
TROUBL	TROUBL
TRYPANOS	TRYPANOS
TUBERK	TUBERKULOZ
UFOL	UFOLOGY
UGOST	UGOSTIT
ULST	ULSTER
ULTRASON	ULTRASON
ULTRATERR	ULTRATERRESTRE
UNIF	UNIFORME
URBAN	URBAN
UROGYNAECOL	UROGYNAECOLOGIA
UROL	UROLOGY
VACCIN	VACCINATION
VALID	VALIDATION
VELOC	VELOCIT
VENER	VENERI
VENEROL	VENEROLOGY
VESTIG	VESTIG
VIDEOTAP	VIDEOTAPING
VIETNAM	VIETNAM
VIGIL	VIGILANC
VIOLIN	VIOLIN
VIROL	VIROLOGY
VIS	VISAYAS
VITAM	VITAMINI
VITAMINOL	VITAMINOLOGY
VOL	VOLUMEN
VOLUNT	VOLUNT
VULCAN	VULCANISM
XENOFOB	XENOFOBIA
XYLOPH	XYLOPHON
YID	YIDDISH
YID	YIDISH
ZAGREB	ZAGREB
ZELAND	ZELAND
ZIMB	ZIMBABWE
ZIRCON	ZIRCONIUM
ZNAC	ZNAC
ZOOL	ZOOLOGY
ZOOPHYSIOL	ZOOPHYSIOLOGY
ZOOVET	ZOOVETERINAR
ZYMOL	ZYMOLOGY
